Entity1	Entity2	Value
fma:Primitive_erythroblast	nci:Basophilic_Erythroblast	0.75
fma:Totipotent_neuroepithelial_stem_cell	nci:Totipotent_Neuroepithelial_Stem_Cell	0.66
fma:Axillary_nerve	nci:Axillary_Nerve	0.57
fma:Brachiocephalic_artery	nci:Innominate_Artery	0.59
fma:Pulmonary_acinus	nci:Pulmonary_Lobule	0.46
fma:Papillary_muscle	nci:Papillary_Muscle	0.54
fma:Fetal_heart	nci:Fetal_Heart	0.56
fma:Endometrium	nci:Endometrium	0.55
fma:Osteoclast	nci:Osteoclast	0.65
fma:Alveolar_sac	nci:Alveolar_Sac	0.56
fma:Extensor_digitorum_longus	nci:Extensor_Digitorum_Longus	0.64
fma:Third_ventricle	nci:Third_Ventricle_of_Brain	0.55
fma:Set_of_trabeculae_of_lymph_node	nci:Lymph_Node_Trabecula	0.48
fma:Outer_nuclear_membrane	nci:Nuclear_Outer_Membrane	0.61
fma:Set_of_hamstring_muscles	nci:Hamstring	0.56
fma:Ulna	nci:Ulna	0.62
fma:Nasolacrimal_duct	nci:Nasolacrimal_Duct	0.65
fma:Eosinophil	nci:Eosinophil	0.67
fma:Surface	nci:Surface	0.5
fma:Quadratus_lumborum	nci:Quadratus_Lumborum	0.66
fma:Hippocampus	nci:Hippocampus	0.55
fma:Middle_cerebral_artery	nci:Middle_Cerebral_Artery	0.62
fma:Selectin	nci:Selectin	0.67
fma:Intermediate	nci:Intermediate	0.5
fma:Celiac_trunk	nci:Coeliac_Artery	0.59
fma:Phalanx_of_finger	nci:Hand_Phalanx	1.0
fma:Left_renal_artery	nci:Left_Renal_Artery	0.62
fma:Trochlear_nerve	nci:Trochlear_Nerve	0.58
fma:Nose	nci:Nose	0.56
fma:Set_of_duodenal_glands	nci:Brunner_s_Gland	0.57
fma:Capsule_of_lens	nci:Lens_Capsule	0.55
fma:Medial_vestibular_nucleus	nci:Medial_Vestibular_Nucleus	0.7
fma:Metanephros	nci:Metanephros	0.64
fma:Anterior_surface_of_prostate	nci:Anterior_Surface_of_the_Prostate	0.54
fma:Lysine	nci:Lysine	0.5
fma:Cymba_conchae_of_pinna	nci:Cymba_Conchae	0.54
fma:Caudate_nucleus	nci:Caudate_Nucleus	0.58
fma:Right_renal_vein	nci:Right_Renal_Vein	0.64
fma:Cystic_duct	nci:Cystic_Duct	0.73
fma:Internal_carotid_nerve_plexus	nci:Internal_Carotid_Nerve_Plexus	0.61
fma:Parasternal_lymph_node	nci:Internal_Mammary_Lymph_Node	0.68
fma:Plasma_membrane	nci:Cellular_Membrane	0.91
fma:Glial_fibrillar_acidic_protein	nci:Glial_Fibrillary_Acidic_Protein	0.67
fma:Orbicularis_oculi	nci:Orbicularis_Oculi	0.67
fma:APUD_cell	nci:APUD_Cell	0.62
fma:Thymus	nci:Thymus_Gland	0.64
fma:Middle_phalanx_of_finger	nci:Middle_Phalanx_of_the_Hand	0.61
fma:Superficial_circumflex_iliac_artery	nci:Superficial_Circumflex_Iliac_Artery	0.57
fma:Zygomatic_arch	nci:Zygomatic_Arch	0.55
fma:Inferior	nci:Inferior	0.5
fma:Cardiac_nerve_plexus	nci:Cardiac_Nerve_Plexus	0.62
fma:Primary_hair	nci:Lanugo	0.55
fma:Sigmoid_artery	nci:Sigmoid_Artery	0.59
fma:Pancreatic_centro_acinar_cell	nci:Pancreatic_Centroacinar_Cell	0.74
fma:Superior_surface_of_liver	nci:Superior_Surface_of_the_Liver	0.54
fma:Sphincter_of_hepatopancreatic_ampulla	nci:Sphincter_of_Oddi	0.55
fma:Free_ribosome	nci:Free_Ribosome	0.79
fma:Corpus_callosum	nci:Corpus_Callosum	0.6
fma:Cerebrospinal_fluid	nci:Cerebrospinal_Fluid	0.59
fma:Xylose	nci:Xylose	0.59
fma:Rib	nci:Rib	0.6
fma:Palatine_salivary_gland	nci:Palatine_Salivary_Gland	0.69
fma:Thigh	nci:Thigh	0.55
fma:Lobe_of_prostate	nci:Prostate_Gland_Lobe	0.65
fma:Common_palmar_digital_artery	nci:Common_Palmar_Digital_Artery	0.6
fma:Broad_ligament_of_uterus	nci:Broad_Ligament	0.49
fma:Parotid_gland	nci:Parotid_Gland	0.67
fma:White_adipose_tissue	nci:White_Adipose_Tissue	0.71
fma:T_helper_cell_type_2	nci:Type_2_Helper_Cell	0.64
fma:Lateral_geniculate_body	nci:External_Geniculate_Body	0.54
fma:Gastric_gland	nci:Fundic_Gland	0.59
fma:Prostatic_utricle	nci:Prostatic_Utricle	0.55
fma:Male_urethra	nci:Male_Urethra	0.7
fma:Suppressor_effector_T_lymphocyte	nci:Suppressor-Effector_T-Lymphocyte	0.6
fma:Mast_cell	nci:Mast_Cell	0.6
fma:Triceps_surae	nci:Triceps_Surae	0.55
fma:External_ear	nci:External_Ear	0.55
fma:Inferior_mesenteric_vein	nci:Inferior_Mesenteric_Vein	0.59
fma:Corpus_luteum	nci:Corpus_Luteum	0.55
fma:Vastus_lateralis	nci:Vastus_Lateralis	0.59
fma:Cuboid_bone	nci:Cuboid_Bone	0.61
fma:Totipotent_stem_cell	nci:Totipotent_Stem_Cell	0.65
fma:Skin_of_prepuce_of_penis	nci:Male_Prepuce	0.52
fma:Set_of_laryngeal_muscles	nci:Laryngeal_Muscle	0.52
fma:Zygote	nci:Zygote	0.61
fma:Membranous_labyrinth	nci:Membranous_Labyrinth	0.55
fma:Left_main_bronchus	nci:Left_Main_Bronchus	0.65
fma:Metathalamus	nci:Geniculate_Body	0.25
fma:Mediastinal_lymph_node	nci:Mediastinal_Lymph_Node	0.77
fma:Semitendinosus	nci:Semitendinosus	0.63
fma:Primordial_germ_cell	nci:Primordial_Germ_Cell	0.58
fma:Inflow_part_of_right_atrium	nci:Sinus_Venarum	0.56
fma:Trunk_of_right_pulmonary_artery	nci:Right_Pulmonary_Artery	0.58
fma:Thoracic_part_of_esophagus	nci:Thoracic_Esophagus	0.56
fma:Bipolar_neuron	nci:Bipolar_Neuron	0.7
fma:Capsule_of_parathyroid_gland	nci:Parathyroid_Gland_Capsule	0.54
fma:Interneuron	nci:Interneuron	0.74
fma:Ependyma_of_fourth_ventricle	nci:Fourth_Ventricle_Ependyma	0.51
fma:Anal_gland	nci:Anal_Gland	0.63
fma:Amacrine_cell	nci:Amacrine_Cell	0.69
fma:Fibrous_capsule_of_spleen	nci:Splenic_Capsule	0.55
fma:Middle_cardiac_vein	nci:Middle_Cardiac_Vein	0.64
fma:Arytenoid_cartilage	nci:Arytenoid_Cartilage	0.64
fma:Deltoid	nci:Deltoid	0.59
fma:Trans_Golgi_network	nci:Trans-Golgi_Network	0.6
fma:Uncus	nci:Uncus	0.55
fma:Fibrocartilage	nci:Fibrocartilage	0.77
fma:Lymph_node_of_neck	nci:Cervical_Lymph_Node	0.62
fma:Circular_fold_of_small_intestine	nci:Valve_of_Kerckring	0.49
fma:Midgut	nci:Midgut	0.56
fma:Electrical_synapse	nci:Electrical_Synapse	0.65
fma:Metamyelocyte	nci:Metamyelocyte	0.66
fma:Somatotroph	nci:Somatotroph	0.5
fma:Caudate_lobe_of_liver	nci:Lobus_Caudatus	0.55
fma:Tendon	nci:Tendon	0.51
fma:Stroma_of_ovarian_cortex	nci:Stroma_of_the_Ovarian_Cortex	0.53
fma:Lateral_corticospinal_tract	nci:Crossed_Pyramidal_Tract	0.31
fma:Auditory_ossicle	nci:Auditory_Ossicle	0.67
fma:Epithelium_of_vagina	nci:Vaginal_Epithelium	0.66
fma:Integument	nci:Skin	0.52
fma:Neuro_endocrine_system	nci:Neuroendocrine_System	0.5
fma:Anterior_parietal_artery	nci:Anterior_Parietal_Artery	0.62
fma:Thoracic_lymph_node	nci:Thoracic_Lymph_Node	0.54
fma:Right_ovary	nci:Right_Ovary	0.64
fma:Nutrient_canal	nci:Haversian_Canal	0.05
fma:Set_of_cervical_glands	nci:Cervical_Gland	0.56
fma:Epithelium_of_terminal_bronchiole	nci:Terminal_Bronchiole_Epithelium	0.74
fma:Pia_arachnoid	nci:Leptomeninges	0.42
fma:Prostate	nci:Prostate_Gland	0.62
fma:Mucosa_of_anal_canal	nci:Anal_Mucosa	0.61
fma:Autonomic_nervous_system	nci:Autonomic_Nervous_System	0.5
fma:Cytoskeletal_protein	nci:Cytoskeletal_Protein	0.53
fma:Wrist_joint	nci:Wrist_Joint	0.62
fma:Pyloric_orifice	nci:Pyloric_Orifice	0.5
fma:Proteoglycan	nci:Proteoglycan	0.5
fma:Cutaneous_vein	nci:Cutaneous_Vein	0.5
fma:Infundibulum_of_hair_follicle	nci:Hair_Follicle_Infundibulum	0.55
fma:Multipotent_stem_cell	nci:Multipotent_Stem_Cell	0.65
fma:Coccyx	nci:Coccyx	0.64
fma:Mucosa_of_esophagus	nci:Esophageal_Mucosa	0.59
fma:Ligament_of_larynx	nci:Laryngeal_Ligament	0.76
fma:Chondroitin_sulfate	nci:Chondroitin_Sulfate	0.56
fma:Keratinized_squamous_cell_of_esophagus	nci:Esophageal_Squamous_Cell	0.81
fma:Mucoid_tissue	nci:Mucous_Connective_Tissue	0.62
fma:Basal_zone_of_heart	nci:Base_of_the_Heart	0.51
fma:Inner_phalangeal_cell_of_cochlea	nci:Inner_Supporting_Cell	0.61
fma:Optic_disc	nci:Optic_Disc	0.55
fma:Inferior_frontal_gyrus	nci:Inferior_Frontal_Gyrus	0.54
fma:Tyrosine	nci:Tyrosine	0.55
fma:Pseudostratified_ciliated_columnar_epithelium	nci:Pseudostratified_Columnar_Ciliated_Epithelium	0.82
fma:Acidophil_cell	nci:Acidophilic_Cell	0.5
fma:Superficial_cervical_artery	nci:Superficial_Cervical_Artery	0.57
fma:Aspartic_acid	nci:Aspartic_Acid	0.55
fma:Interphalangeal_joint_of_toe	nci:Interphalangeal_Joint_of_the_Foot	0.52
fma:Early_endosome	nci:Endocytotic_Vesicle	0.74
fma:Common_cardinal_vein	nci:Common_Cardinal_Vein	0.6
fma:Lower_lobe_of_lung	nci:Lung_Lower_Lobe	0.64
fma:Epithelium_of_bronchiole	nci:Bronchiole_Epithelium	0.72
fma:Fusiform_cell	nci:Fusiform_Cell	0.5
fma:Round_ligament_of_uterus	nci:Round_Ligament_of_the_Uterus	0.56
fma:Infra_orbital_artery	nci:Infraorbital_Artery	0.59
fma:Set_of_renal_pyramids	nci:Renal_Pyramid	0.49
fma:Amygdala	nci:Amygdaloid_Body	0.54
fma:Renal_vein	nci:Renal_Vein	0.66
fma:Epinephrine	nci:Epinephrine	0.5
fma:Hepatic_lobule	nci:Hepatic_Lobule	0.54
fma:Coronary_ligament	nci:Coronary_Ligament	0.55
fma:Anterior_limiting_lamina_of_cornea	nci:Bowman_s_Membrane	0.56
fma:Maxilla	nci:Maxilla	0.62
fma:Hair_root	nci:Hair_Root	0.55
fma:Sublingual_artery	nci:Sublingual_Artery	0.59
fma:Thyroepiglotticus	nci:Thyroepiglottic_Muscle	0.58
fma:Segmentation	nci:Segment	0.42
fma:Hemisphere_of_cerebellum	nci:Hemisphere_of_the_Cerebellum	0.52
fma:Musculature_of_face	nci:Facial_Muscle	0.56
fma:Pancreatic_islet	nci:Islet_of_Langerhans	0.56
fma:Ganglion_cell	nci:Ganglion_Cell	0.5
fma:Lateral_thyrohyoid_ligament	nci:Lateral_Thyrohyoid_Ligament	0.66
fma:Adrenal_cortex	nci:Adrenal_Cortex	0.55
fma:Longissimus_capitis	nci:Longissimus_Capitis	0.59
fma:Costochondral_joint	nci:Costochondral_Joint	0.53
fma:Arm	nci:Upper_Extremity	0.28
fma:Vomer	nci:Vomer	0.55
fma:Interventricular_foramen	nci:Interventricular_Foramen	0.5
fma:Bronchial_tree	nci:Bronchial_Tree	0.66
fma:Endocrine_pancreas	nci:Islet_of_Langerhans	0.5
fma:L_selectin	nci:Selectin-L	0.64
fma:B_lymphocyte	nci:B-Lymphocyte	0.56
fma:Infraclavicular_part_of_chest	nci:Infraclavicular_Region	0.55
fma:Centromedian_nucleus	nci:Centromedian_Nucleus_of_the_Thalamus	0.57
fma:Spleen	nci:Spleen	0.64
fma:Preganglionic_neuron	nci:Visceral_Efferent_Neuron	0.65
fma:Spinal_accessory_nerve	nci:Accessory_Nerve	0.55
fma:Intercellular_junction	nci:Cell_Junction	0.68
fma:Set_of_carpometacarpal_joints	nci:Carpometacarpal_Joint	0.54
fma:Collateral_sulcus	nci:Collateral_Sulcus	0.5
fma:Temporal_vein	nci:Temporal_Vein	0.6
fma:Midbrain_tectum	nci:Tectum_Mesencephali	0.05
fma:Intralaminar_nuclear_group_of_thalamus	nci:Intralaminar_Nucleus	0.46
fma:Root_of_spinal_nerve	nci:Spinal_Nerve_Root	0.82
fma:Hypoglossal_nerve_nucleus	nci:Hypoglossal_Nucleus	0.59
fma:Columnar_cell	nci:Columnar_Cell	0.61
fma:Red_pulp_of_spleen	nci:Splenic_Red_Pulp	0.6
fma:Guanyl_nucleotide_binding_protein	nci:G_Protein	0.49
fma:Erythrocyte	nci:Erythrocyte	0.65
fma:Epithelium_of_choroid_plexus	nci:Choroid_Plexus_Epithelium	0.57
fma:Endodermal_cell	nci:Endoderm_Cell	0.66
fma:Semen	nci:Seminal_Fluid	0.11
fma:Smooth_muscle_tissue_of_prostate	nci:Prostatic_Muscular_Tissue	0.62
fma:Odontoblast	nci:Odontoblast	0.6
fma:Paranasal_sinus	nci:Paranasal_Sinus_Retired	0.5
fma:Appendix	nci:Vermiform_Appendix	0.56
fma:Simple_cuboidal_epithelium	nci:Simple_Cuboidal_Epithelium	0.72
fma:Pituicyte	nci:Pituicyte	0.68
fma:Set_of_pelvic_lymph_nodes	nci:Pelvic_Lymph_Node	0.54
fma:Processus_cochleariformis	nci:Processus_Cochleariformis	0.55
fma:Plasma_transmembrane_protein	nci:Transmembrane_Protein	0.58
fma:Epithelium_of_bronchus	nci:Bronchial_Epithelium	0.74
fma:Fibrous_capsule_of_kidney	nci:Renal_Capsule	0.25
fma:Sternohyoid	nci:Sternohyoid	0.63
fma:Sacrococcygeal_joint	nci:Sacrococcygeal_Joint	0.58
fma:Transverse_plane	nci:Transverse_Plane	0.5
fma:Mesoderm	nci:Mesoderm	0.63
fma:Cricothyroid_ligament	nci:Cricothyroid_Ligament	0.54
fma:Distal_phalanx_of_toe	nci:Distal_Phalanx_of_Foot	0.52
fma:Cell_morphology	nci:Cellular_Morphology	0.5
fma:Rectus_femoris	nci:Rectus_Femoris	0.59
fma:Pyramidalis	nci:Pyramidalis	0.66
fma:Hippocampal_sulcus	nci:Hippocampal_Sulcus	0.5
fma:Inferior_suprarenal_artery	nci:Inferior_Suprarenal_Artery	0.57
fma:Rostral	nci:Cranial	0.0
fma:Lateral_wall_of_nasopharynx	nci:Lateral_Wall_of_the_Nasopharynx	0.55
fma:Calcaneus	nci:Calcaneum	0.57
fma:Eotaxin_3	nci:Small_Inducible_Cytokine-A26	0.71
fma:Anal_canal	nci:Anal_Canal	0.56
fma:Set_of_costovertebral_joints	nci:Costovertebral_Joint	0.55
fma:Myoepithelial_cell	nci:Myoepithelial_Cell	0.56
fma:Islet_cell	nci:Endocrine_Pancreas	0.0
fma:Lamina_propria	nci:Lamina_Propria	0.63
fma:Set_of_regional_lymph_nodes	nci:Regional_Lymph_Node	0.56
fma:Thymosin	nci:Thymosin	0.57
fma:Portion_of_epithelium	nci:Epithelial_Tissue	0.75
fma:Sternoclavicular_joint	nci:Sternoclavicular_Joint	0.62
fma:Myeloid_stem_cell	nci:Myeloid_Progenitor_Cell	0.57
fma:Testis	nci:Testis	0.7
fma:Great_cardiac_vein	nci:Great_Cardiac_Vein	0.64
fma:Lamina_lucida	nci:Lamina_Lucida	0.56
fma:Lesser_omentum	nci:Lesser_Omentum	0.63
fma:Apex_of_lung_viewed_anatomically	nci:Apex_of_the_Lung	0.26
fma:Set_of_nails_of_fingers	nci:Fingernail	0.49
fma:Hip_bone	nci:Pelvic_Bone	0.57
fma:Inner_cell_mass	nci:Inner_Cell_Mass	0.64
fma:Set_of_gastric_pits	nci:Gastric_Pit	0.49
fma:Histidine	nci:Histidine	0.5
fma:Follicular_dendritic_cell	nci:Follicular_Dendritic_Cell	0.64
fma:Endosteum	nci:Endosteum	0.54
fma:Posterior_surface_of_kidney	nci:Posterior_Surface_of_the_Kidney	0.53
fma:Popliteal_vein	nci:Popliteal_Vein	0.58
fma:Lower_lobe_of_left_lung	nci:Lower_Lobe_of_the_Left_Lung	0.62
fma:Hemopoietic_stem_cell	nci:Hematopoietic_Stem_Cell	0.59
fma:Phosphatidylinositol	nci:Phosphatidylinositol	0.56
fma:Adipose_tissue	nci:White_Adipose_Tissue	0.55
fma:Mucosa_associated_lymphoid_tissue	nci:Mucosa-Associated_Lymphoid_Tissue	0.71
fma:Set_of_arteries	nci:Artery	0.48
fma:Gastrophrenic_ligament	nci:Gastrophrenic_Ligament	0.55
fma:Cartilage_tissue	nci:Cartilage	0.45
fma:Left_lung	nci:Left_Lung	0.69
fma:Interphalangeal_joint_of_toe	nci:Toe_Joint	0.28
fma:Subdivision_of_external_carotid_artery	nci:External_Carotid_Artery_Branch	0.66
fma:Set_of_anal_sinuses	nci:Anal_Sinus	0.47
fma:Sural_artery	nci:External_Sural_Artery	0.57
fma:Superior_oblique	nci:Superior_Oblique_Muscle	0.61
fma:Neutrophil	nci:Neutrophil	0.67
fma:Epithelioid_cell	nci:Epithelioid_Cell	0.59
fma:Adenine	nci:Adenine	0.56
fma:Skin_of_prepuce_of_penis	nci:Prepuce	0.39
fma:Tuberculum_sellae	nci:Tuberculum_Sellae	0.55
fma:Set_of_olfactory_nerves	nci:Olfactory_Nerve	0.54
fma:Set_of_ciliary_processes	nci:Ciliary_Process	0.48
fma:Posterior_longitudinal_ligament	nci:Posterior_Longitudinal_Ligament	0.6
fma:Lateral_lobe_of_prostate	nci:Lateral_Lobe_of_the_Prostate	0.56
fma:Glucose	nci:Glucose	0.59
fma:Episcleral_layer_of_eyeball	nci:Episclera	0.55
fma:Scaffold_protein	nci:Scaffolding_Protein	0.53
fma:Eotaxin_2	nci:Small_Inducible_Cytokine-A24	0.71
fma:Renal_corpuscle	nci:Renal_Corpuscle	0.55
fma:Dentate_gyrus_of_hippocampal_formation	nci:Dentate_Gyrus	0.54
fma:Solitary_tract_nuclear_complex	nci:Nucleus_of_the_Solitary_Tract	0.48
fma:Pyramidal_cell	nci:Pyramidal_Cell	0.5
fma:Multilaminar_epithelium	nci:Stratified_Epithelium	0.76
fma:Inferior_sagittal_sinus	nci:Inferior_Sagittal_Sinus	0.6
fma:Androgen	nci:Therapeutic_Androgen	0.53
fma:Parieto_occipital_sulcus	nci:Parieto-occipital_Sulcus	0.5
fma:Subdivision_of_internal_carotid_artery	nci:Internal_Carotid_Artery_Branch	0.68
fma:Actin_binding_protein	nci:Actin-Binding_Protein	0.59
fma:Vestibular_sensory_cell	nci:Vestibular_Hair_Cell	0.62
fma:Vitreous_body	nci:Vitreous_Body	0.55
fma:Anterior_cruciate_ligament	nci:Anterior_Cruciate_Ligament	0.63
fma:Posterior_cochlear_nucleus	nci:Dorsal_Cochlear_Nucleus	0.58
fma:External	nci:External	0.5
fma:Tuber_cinereum	nci:Tuber_Cinereum	0.55
fma:Inferior_epigastric_artery	nci:Inferior_Epigastric_Artery	0.57
fma:Galactose	nci:Galactose	0.59
fma:Cis_Golgi_network	nci:Cis-Golgi_Network	0.6
fma:Long_insular_gyrus	nci:Gyrus_Longus_Insulae	0.54
fma:T_helper_cell_type_1	nci:Type_1_Helper_Cell	0.64
fma:Nucleus_of_solitary_tract	nci:Nucleus_of_the_Solitary_Tract	0.48
fma:Striated_muscle_cell	nci:Striated_Muscle_Tissue_Cell	0.68
fma:Axial	nci:Axial	0.5
fma:Secretory_cell	nci:Secretory_Cell	0.5
fma:Nuclear_pore_complex	nci:Nuclear_Pore_Complex	0.62
fma:Intercarpal_joint	nci:Carpal_Joint	0.59
fma:Capillary	nci:Capillary	0.61
fma:CxC_chemokine	nci:Alpha_Chemokine	0.57
fma:Fascia_organ	nci:Fascia	0.46
fma:Endothelium_of_lymphatic_vessel	nci:Lymphatic_Vessel_Endothelium	0.66
fma:Lingual_salivary_gland	nci:Lingual_Salivary_Gland	0.69
fma:Internal_pyramidal_layer_of_cerebral_cortex	nci:Ganglionic_Layer	0.53
fma:Fusiform_gyrus	nci:Occipital-temporal_Gyrus	0.54
fma:Superior_thyroid_artery	nci:Superior_Thyroid_Artery	0.63
fma:Septum_primum	nci:Septum_Primum	0.56
fma:Tubulin	nci:Tubulin	0.58
fma:Neural_crest_cell	nci:Neural_Crest_Cell	0.65
fma:Portion_of_epithelium	nci:Epithelium	0.73
fma:Subcostal_vein	nci:Subcostal_Vein	0.67
fma:Hepatic_portal_vein	nci:Portal_Vein	0.59
fma:Neurofilament	nci:Neurofilament	0.73
fma:Set_of_carpal_bones	nci:Carpus_Bone	0.44
fma:Parasympathetic_nervous_system	nci:Parasympathetic_Nervous_System	0.5
fma:Wall_of_prostatic_duct	nci:Wall_of_Human_Prostatic_Duct	0.55
fma:Vasoactive_intestinal_peptide	nci:Vasoactive_Intestinal_Peptide	0.5
fma:Pulmonary_trunk_sinus	nci:Sinus_of_Valsava	0.54
fma:Epithelium_of_ciliary_body	nci:Ciliary_Epithelium	0.66
fma:Somatostatin	nci:Somatostatin	0.5
fma:Microtubule	nci:Microtubule	0.61
fma:Inferior_thyroid_artery	nci:Inferior_Thyroid_Artery	0.58
fma:Set_of_costochondral_joints	nci:Costochondral_Joint	0.55
fma:Neuroblast	nci:Neuroblast	0.62
fma:Corticotroph	nci:Corticotrope_Cell	0.76
fma:Middle_cranial_fossa	nci:Middle_Fossa	0.5
fma:Embryonic_cell	nci:Blastomere	0.3
fma:Body_surface	nci:Body_Surface	0.58
fma:Posterior_choroidal_artery	nci:Posterior_Choroidal_Artery	0.66
fma:Corneal_endothelium	nci:Corneal_Endothelium	0.55
fma:Umbilical_vein	nci:Umbilical_Vein	0.62
fma:Flatulence	nci:Flatus	0.34
fma:Anterior_commissure	nci:Anterior_Commissure	0.55
fma:Oocyte	nci:Egg	0.74
fma:Syncytial_trophoblast	nci:Syncytiotrophoblast	0.64
fma:Vocal_fold	nci:True_Vocal_Cord	0.55
fma:Decidual_cell	nci:Decidual_Cell	0.56
fma:Thyroid_cartilage	nci:Thyroid_Cartilage	0.65
fma:Temporal_fossa	nci:Temporal_Fossa	0.5
fma:Theca_lutein_cell	nci:Theca_Lutein_Cell	0.65
fma:Lamina_propria_of_bronchus	nci:Bronchus_Lamina_Propria	0.67
fma:Set_of_dopaminergic_cells	nci:Dopaminergic_Cell	0.53
fma:Eyelid	nci:Eyelid	0.78
fma:Left_common_carotid_artery	nci:Left_Common_Carotid_Artery	0.63
fma:Cardia_of_stomach	nci:Cardia	0.56
fma:Body_of_lateral_ventricle	nci:Body_of_the_Lateral_Ventricle	0.52
fma:Branch_of_basilar_artery	nci:Basilar_Artery_Branch	0.8
fma:Wall_of_smooth_endoplasmic_reticulum	nci:Membrane_of_the_Smooth_Endoplasmic_Reticulum	0.61
fma:Histamine	nci:Histamine	0.5
fma:Set_of_hairs	nci:Hair	0.51
fma:Medial_circumflex_femoral_artery	nci:Medial_Circumflex_Artery	0.63
fma:Skeletal_system	nci:Skeletal_System	0.57
fma:Hemopoietic_stem_cell	nci:Stem_Cell	0.36
fma:Superficial_vein	nci:Superficial_Vein	0.5
fma:Sublingual_gland	nci:Sublingual_Salivary_Gland	0.67
fma:Superior_thoracic_artery	nci:Superior_Thoracic_Artery	0.57
fma:Set_of_basal_ganglia	nci:Basal_Ganglia	0.5
fma:Lateral_posterior_nucleus	nci:Lateral_Posterior_Nucleus_of_the_Thalamus	0.53
fma:Desmosome	nci:Desmosome	0.65
fma:Diencephalon	nci:Diencephalon	0.55
fma:Tonsillar_fossa	nci:Tonsillar_Fossa	0.5
fma:Set_of_gastric_folds	nci:Gastric_Rugae	0.5
fma:Tricuspid_valve	nci:Tricuspid_Valve	0.66
fma:Fundus_of_gallbladder	nci:Gallbladder_Fundus	0.56
fma:Scleral_venous_sinus	nci:Canal_of_Schlemm	0.5
fma:Type_IV_collagen	nci:Collagen-IV	0.61
fma:Uterine_tube	nci:Fallopian_Tube	0.69
fma:Submucosa_of_bronchus	nci:Bronchus_Submucosa	0.49
fma:Internal_capsule	nci:Internal_Capsule	0.54
fma:Phalanx_of_middle_finger	nci:Middle_Phalanx_of_the_Hand	0.65
fma:Dermis	nci:Dermis	0.54
fma:Central	nci:Center	0.5
fma:Mechanoreceptor	nci:Mechanoreceptor	0.6
fma:Argentaffin_cell	nci:Argentaffin_Cell	0.5
fma:Set_of_transverse_folds_of_rectum	nci:Transverse_Rectal_Fold	0.44
fma:Hemoglobin	nci:Hemoglobin	0.55
fma:Lumbar_nerve	nci:Lumbar_Nerve	0.6
fma:Superior_rectus	nci:Superior_Rectus_Muscle	0.6
fma:Diaphragma_sellae	nci:Diaphragma_Sellae	0.56
fma:Perilymph	nci:Perilymph	0.58
fma:Genu_of_corpus_callosum	nci:Genu_of_the_Corpus_Callosum	0.52
fma:Thyrohyoid_ligament	nci:Thyrohyoid_Ligament	0.72
fma:Sclera	nci:Sclera	0.55
fma:Portal_vein	nci:Portal_Vein	0.53
fma:Paranasal_sinus	nci:Paranasal_Sinus	0.67
fma:Sesamoid_bone	nci:Sesamoid_Bone	0.6
fma:Uvula	nci:Uvula	0.56
fma:Mucosa_of_stomach	nci:Gastric_Mucosa	0.6
fma:Cardiac_sphincter	nci:Lower_Esophageal_Sphincter	0.41
fma:Secondary_nodular_lymphoid_tissue	nci:Lymph_Node_Germinal_Center	0.57
fma:Set_of_ducts	nci:Duct	0.52
fma:Tonsillar_crypt	nci:Tonsillar_Crypt	0.5
fma:Woven_bone	nci:Immature_Bone	0.77
fma:Leptomeninx	nci:Leptomeninges	0.51
fma:Set_of_tarsal_bones	nci:Tarsus_Bone	0.44
fma:Portion_of_tissue	nci:Normal_Tissue	0.5
fma:Glomerular_capsule	nci:Bowman_s_Capsule	0.55
fma:Tarsal_bone	nci:Tarsus_Bone	0.52
fma:Natural_killer_cell	nci:Natural_Killer_Cell	0.68
fma:Renal_pelvis	nci:Renal_Pelvis	0.55
fma:Vestibular_labyrinth	nci:Vestibule	0.38
fma:Duodenum	nci:Duodenum	0.56
fma:Islet_cell	nci:Islet_of_Langerhans	0.48
fma:Phagosome	nci:Phagosome	0.74
fma:Metaphysis	nci:Metaphysis	0.51
fma:Set_of_popliteal_lymph_nodes	nci:Popliteal_Lymph_Node	0.59
fma:Periventricular_nucleus	nci:Arcuate_Nucleus	0.1
fma:Set_of_inguinal_lymph_nodes	nci:Inguinal_Lymph_Node	0.61
fma:Thoraco_acromial_artery	nci:Acromial_Thoracic_Artery	0.57
fma:Posterior_surface_of_prostate	nci:Posterior_Surface_of_the_Prostate	0.54
fma:Epithelium_of_paranasal_sinus	nci:Paranasal_Sinus_Epithelium	0.71
fma:Radial_artery	nci:Radial_Artery	0.57
fma:Liver_cell	nci:Hepatocyte	0.48
fma:Musculature_of_anterior_abdominal_wall	nci:Anterior_Abdominal_Wall_Muscle	0.53
fma:Organ_component_gland	nci:Gland	0.67
fma:Solitary_tract_nuclear_complex	nci:Solitary_Nucleus	0.54
fma:Umbilicus	nci:Umbilical_Region	0.56
fma:Mucosa	nci:Mucosa	0.61
fma:Coccygeal_nerve	nci:Coccygeal_Nerve	0.6
fma:Trophoblast_cell	nci:Trophoblastic_Cell	0.66
fma:Ileal_vein	nci:Ileal_Vein	0.59
fma:Anterior	nci:Anterior	0.5
fma:Lateral_wall_of_oropharynx	nci:Lateral_Wall_of_the_Oropharynx	0.55
fma:Set_of_bronchi	nci:Bronchus	0.54
fma:Ischiocavernosus	nci:Ischiocavernosus	0.63
fma:Muscular_layer_of_pharynx	nci:Pharyngeal_Muscle	0.19
fma:Gonadotroph	nci:Gonadotroph_Cell	0.72
fma:Outer_plexiform_layer_of_retina	nci:Outer_Plexiform_Layer	0.58
fma:Set_of_regions_of_back	nci:Dorsum	0.0
fma:Norepinephrine	nci:Norepinephrine	0.5
fma:Wall_of_urinary_bladder	nci:Bladder_Wall	0.43
fma:Spiral_organ_of_cochlea	nci:Organ_of_Corti	0.55
fma:Pinealocyte	nci:Pineocyte	0.47
fma:Jugular_foramen	nci:Jugular_Foramen	0.5
fma:Hepatogastric_ligament	nci:Hepatogastric_Ligament	0.55
fma:Right_hepatic_duct	nci:Right_Hepatic_Duct	0.67
fma:Muscle_of_face	nci:Facial_Muscle	0.54
fma:Costal_arch	nci:Costal_Arch	0.5
fma:Hilum	nci:Hilum	0.5
fma:Membranous_urethra	nci:Membranous_Urethra	0.56
fma:Right_testicular_artery	nci:Right_Spermatic_Artery	0.63
fma:Principal_sensory_nucleus_of_trigeminal_nerve	nci:Principal_Sensory_Nucleus_of_the_Trigeminal_Nerve	0.57
fma:Cochlear_hair_cell	nci:Hair_Cell	0.72
fma:Rough_endoplasmic_reticulum_cistern	nci:Cisterna_of_the_Rough_Endoplasmic_Reticulum	0.6
fma:Medulla_of_thymus	nci:Thymus_Medulla	0.56
fma:Set_of_microglial_cells	nci:Microglia	0.56
fma:External_naris	nci:Nostril	0.5
fma:Cochlear_duct_of_membranous_labyrinth	nci:Cochlear_Duct	0.55
fma:Inferior_hypogastric_nerve_plexus	nci:Inferior_Hypogastric_Nerve_Plexus	0.61
fma:Glans_of_clitoris	nci:Glans_Clitoris	0.55
fma:Glomerulus	nci:Glomerulus	0.55
fma:Portal_triad	nci:Portal_Triad	0.56
fma:Oculomotor_nuclear_complex	nci:Oculomotor_Nucleus	0.54
fma:Flexor_digitorum_profundus	nci:Flexor_Digitorum_Profundus	0.59
fma:Thymocyte	nci:Thymocyte	0.62
fma:Set_of_celiac_lymph_nodes	nci:Celiac_Lymph_Node	0.55
fma:Lumbosacral_nerve_plexus	nci:Lumbosacral_Plexus	0.69
fma:Set_of_oesophageal_glands	nci:Esophageal_Gland	0.54
fma:Superior_mesenteric_vein	nci:Superior_Mesenteric_Vein	0.58
fma:Primordium	nci:Primordium	0.64
fma:Calcaneal_tendon	nci:Achilles_Tendon	0.54
fma:Smooth_endoplasmic_reticulum	nci:Smooth_Endoplasmic_Reticulum	0.66
fma:Transitional_epithelial_cell	nci:Transitional_Cell	0.51
fma:Adventitia	nci:Tunica_Adventitia	0.39
fma:Skin_of_knee	nci:Knee_Skin	0.62
fma:Helix	nci:Helix_Structure	0.55
fma:Pectinate_line	nci:Pectinate_Line	0.5
fma:Whole_portion_of_vitreous_humor	nci:Vitreous_Humor	0.57
fma:Lacrimal_artery	nci:Lacrimal_Artery	0.59
fma:Dorsolateral_fasciculus_of_medulla	nci:Tract_of_Lissauer	0.54
fma:Stratified_squamous_epithelium	nci:Stratified_Squamous_Epithelium	0.74
fma:Longitudinal	nci:Longitudinal	0.5
fma:Lobe_of_liver	nci:Liver_Lobe	0.64
fma:Nitrergic_neuron	nci:Nitrergic_Neuron	0.71
fma:Set_of_fungiform_papillae	nci:Fungiform_Papilla	0.55
fma:Short_bone	nci:Short_Bone	0.64
fma:Lateral_thoracic_artery	nci:Lateral_Thoracic_Artery	0.58
fma:Set_of_eyelids	nci:Eyelid	0.48
fma:Peripheral	nci:Peripheral	0.5
fma:Branch_of_ulnar_artery	nci:Ulnar_Artery_Branch	0.6
fma:Pulmonary_alveolar_epithelium	nci:Alveolar_Epithelium	0.62
fma:Set_of_interphalangeal_joints_of_foot	nci:Toe_Joint	0.05
fma:Integument_of_limb	nci:Skin_of_the_Extremity	0.11
fma:Basal_lamina	nci:Lamina_Densa	0.17
fma:Hyoid_bone	nci:Hyoid_Bone	0.64
fma:Fissure	nci:Fissure	0.5
fma:Cerebellopontine_angle	nci:Cerebellopontine_Angle	0.55
fma:Posterior	nci:Posterior	0.5
fma:Occluding_cell_junction	nci:Tight_Junction	0.62
fma:Crypt_of_Lieberkuhn_of_large_intestine	nci:Large_Intestinal_Crypt_of_the_Lieberkuhn	0.61
fma:Inferior_parathyroid_gland	nci:Inferior_Parathyroid_Gland	0.72
fma:Outer_nuclear_layer_of_retina	nci:Outer_Nuclear_Layer_of_Retina	0.6
fma:Mesothelium	nci:Mesothelium	0.52
fma:Leukocyte	nci:Leukocyte	0.63
fma:Vestibular_nuclear_complex	nci:Vestibular_Nucleus	0.53
fma:Renal_column	nci:Cortical_Column	0.55
fma:Flexor_carpi_ulnaris	nci:Flexor_Carpi_Ulnaris	0.59
fma:Fascial_sheath_of_eyeball	nci:Substantia_Propria	0.55
fma:Hepatic_macrophage	nci:Kupffer_Cell	0.71
fma:Elastic_cartilage	nci:Elastic_Cartilage	0.77
fma:Splenic_artery	nci:Splenic_Artery	0.59
fma:Microtubule_triplet	nci:Microtubule_Triplet	0.56
fma:Endothelium_of_vein	nci:Vein_Endothelium	0.61
fma:Body_of_uterus	nci:Corpus_Uteri	0.55
fma:Femoral_nerve	nci:Femoral_Nerve	0.57
fma:Subdivision_of_deep_femoral_artery	nci:Deep_Femoral_Artery_Branch	0.63
fma:Anterior_tibial_vein	nci:Anterior_Tibial_Vein	0.54
fma:Set_of_capsular_ligaments	nci:Capsular_Ligament	0.56
fma:Cervical_nerve	nci:Cervical_Nerve	0.55
fma:Set_of_aggregated_lymphoid_nodules_of_small_intestine	nci:Peyer_s_Patch	0.5
fma:Subthalamic_nucleus	nci:Subthalamic_Nucleus	0.62
fma:Vertebral_vein	nci:Vertebral_Vein	0.58
fma:Helicotrema	nci:Helicotrema	0.5
fma:Zygomaticus_minor	nci:Zygomaticus_Minor	0.66
fma:Abdominal_part_of_esophagus	nci:Abdominal_Esophagus	0.56
fma:Parietal_lobe	nci:Parietal_Lobe_of_the_Brain	0.54
fma:Spinal_accessory_nerve	nci:Spinal_Accessory_Nerve	0.5
fma:Basophil	nci:Basophil	0.67
fma:Sphenoidal_sinus	nci:Sphenoid_Sinus	0.52
fma:Talus	nci:Astragalus	0.31
fma:Wall_of_lysosome	nci:Membrane_of_the_Lysosome	0.61
fma:Bowman_s_space	nci:Urinary_Space	0.5
fma:Left_colic_flexure	nci:Splenic_Flexure	0.56
fma:Endomysium	nci:Endomysium	0.55
fma:Nucleus_of_solitary_tract	nci:Solitary_Nucleus	0.54
fma:Small_cardiac_vein	nci:Small_Cardiac_Vein	0.64
fma:Capsule_of_lymph_node	nci:Lymph_Node_Capsule	0.55
fma:Musculoskeletal_system	nci:Musculoskeletal_System	0.68
fma:Cartilage_of_external_ear	nci:External_Ear_Cartilage	0.59
fma:Glenohumeral_joint	nci:Shoulder_Joint	0.62
fma:Nucleolus	nci:Nucleolus	0.62
fma:Anus	nci:Anus	0.5
fma:E_cadherin	nci:E-Cadherin	0.64
fma:Immunoglobulin	nci:Immunoglobulin	0.67
fma:Lymphatic_vessel	nci:Lymphatic_Vessel	0.75
fma:Set_of_phalanges_of_foot	nci:Phalanx_of_the_Foot	0.5
fma:Zygomaticus_major	nci:Zygomaticus_Major	0.66
fma:Flexor_hallucis_longus	nci:Flexor_Hallucis_Longus	0.64
fma:Bone_of_talus	nci:Astragalus	0.07
fma:Cricothyroid_muscle	nci:Cricothyroid_Muscle	0.66
fma:Skeletal_muscle_cell	nci:Rhabdomyocyte	0.8
fma:Phosphatidylserine	nci:Phosphatidylserine	0.55
fma:Focal_adhesion_plaque	nci:Cell-to-extracellular_Matrix_Junction	0.14
fma:Myocardium	nci:Myocardium	0.59
fma:Set_of_tarsal_glands	nci:Meibomian_Gland	0.55
fma:Placenta	nci:Placenta	0.65
fma:Perineal_muscle	nci:Perineal_Muscle	0.56
fma:Osteocyte	nci:Osteocyte	0.65
fma:Atlanto_occipital_joint	nci:Atlanto-occipital_Joint	0.62
fma:Coronary_artery	nci:Coronary_Artery	0.75
fma:Muscularis_mucosae_of_stomach	nci:Gastric_Muscular_Coat	0.41
fma:Primary_ossification_center	nci:Primary_Ossification_Center	0.55
fma:Elastic_fiber	nci:Elastic_Fiber	0.56
fma:Neural_cell_adhesion_molecule	nci:CD56_Antigen	0.5
fma:Broca_s_area	nci:Area_of_Broca	0.47
fma:Subcapsular_lens_epithelium	nci:Subcapsular_Epithelium_of_the_Lens	0.67
fma:Posterior_cerebral_artery	nci:Posterior_Cerebral_Artery	0.62
fma:Villus	nci:Villus	0.56
fma:Lateral_frontobasal_artery	nci:Lateral_Orbitofrontal_Artery	0.62
fma:Basal_cell_layer_of_epidermis	nci:Rete_Malpighii	0.55
fma:Set_of_conjunctival_glands	nci:Gland_of_Krause	0.1
fma:Root_of_lumbar_spinal_nerve	nci:Lumbar_Spinal_Nerve_Root	0.66
fma:Hepatic_artery	nci:Hepatic_Artery	0.55
fma:Sinus_venosus	nci:Sinus_Venosus	0.64
fma:Olfactory_nerve	nci:Olfactory_Nerve	0.55
fma:Toe	nci:Toe	0.56
fma:Valve_of_coronary_sinus	nci:Coronary_Valve	0.61
fma:Flatus	nci:Flatulence	0.34
fma:Stapes	nci:Stapes	0.59
fma:Cerebral_cortex	nci:Cortex	0.54
fma:Phalanx_of_toe	nci:Foot_Phalanx	0.91
fma:Reticular_cell	nci:Reticular_Cell	0.66
fma:Thorax	nci:Thorax	0.55
fma:Levator_labii_superioris	nci:Levator_Labii_Superioris	0.66
fma:Glossopharyngeal_nerve	nci:Glossopharyngeal_Nerve	0.58
fma:Proprioceptor	nci:Proprioceptor	0.59
fma:Descending_aorta	nci:Descending_Aorta	0.59
fma:Intercostal_muscle	nci:Intercostal_Muscle	1.0
fma:Flexor_digitorum_longus	nci:Flexor_Digitorum_Longus	0.64
fma:Alveolar_macrophage	nci:Alveolar_Macrophage	0.71
fma:Brachial_artery	nci:Brachial_Artery	0.58
fma:Fundus_of_uterus	nci:Fundus_Uteri	0.55
fma:Smooth_muscle_cell	nci:Smooth_Muscle_Tissue_Cell	0.59
fma:Keratin_filament	nci:Keratin_Filament	0.77
fma:Right_inguinal_part_of_abdomen	nci:Right_Inguinal_Region	0.61
fma:Teres_major	nci:Teres_Major_Muscle	0.59
fma:Plasma_membrane_of_muscle_cell	nci:Sarcolemma	0.55
fma:Waist	nci:Waist	0.56
fma:Ventral_lateral_nucleus	nci:Ventrolateral_Nucleus_of_the_Thalamus	0.55
fma:Geniculate_ganglion	nci:Geniculate_Ganglion	0.62
fma:Alanine	nci:Alanine	0.55
fma:Dermal_epidermal_junction	nci:Dermo-Epidermal_Junction	0.54
fma:Thyroidea_ima_artery__variant_	nci:Thyroid_Ima_Artery	0.59
fma:Cortex_of_kidney	nci:Renal_Cortex	0.55
fma:Mesonephros	nci:Mesonephros	0.64
fma:Linker_DNA	nci:Linker_DNA	0.5
fma:Left_brachiocephalic_vein	nci:Left_Innominate_Vein	0.64
fma:Insula	nci:Insula	0.54
fma:Purkinje_fiber	nci:Purkinje_Fiber	0.55
fma:Set_of_fontanelles	nci:Fontanelle	0.49
fma:Type_G_enteroendocrine_cell	nci:G-Cell	0.71
fma:Macula_of_utricle_of_membranous_labyrinth	nci:Macula_of_Utricle	0.55
fma:Melanocyte	nci:Melanocyte	0.59
fma:Internal_intercostal_muscle	nci:Internal_Intercostal_Muscle	0.72
fma:Calcarine_sulcus	nci:Calcarine_Sulcus	0.5
fma:Vestibular_nerve	nci:Vestibular_Nerve	0.57
fma:Dorsal_interosseous_of_foot	nci:Dorsal_Foot_Interosseous_Muscle	0.55
fma:Left_suprarenal_vein	nci:Left_Suprarenal_Vein	0.64
fma:Palpebral_conjunctiva	nci:Palpebral_Conjunctiva	0.56
fma:Occipital_artery	nci:Occipital_Artery	0.63
fma:Superior_parathyroid_gland	nci:Superior_Parathyroid_Gland	0.72
fma:Interventricular_foramen	nci:Foramen_of_Monroe	0.11
fma:Gracile_fasciculus_of_medulla	nci:Tract_of_Goll	0.43
fma:Dental_pulp	nci:Dental_Pulp	0.53
fma:Buccal_surface	nci:Buccal_Surface	0.57
fma:Right_hypochondrium	nci:Right_Hypochondriac_Region	0.61
fma:Metatarsophalangeal_joint	nci:Metatarsophalangeal_Joint	0.57
fma:Lymphoid_tissue	nci:Lymphoid_Tissue	0.72
fma:Visceral_pleura	nci:Visceral_Pleura	0.55
fma:Dense_regular_collagenous_tissue	nci:Regular_Dense_Connective_Tissue	0.65
fma:Body_of_epididymis	nci:Body_of_the_Epididymis	0.52
fma:Pyloric_sphincter	nci:Pyloric_Sphincter	0.55
fma:Set_of_phalanges	nci:Hand_Phalanx	0.25
fma:Septum_secundum	nci:Septum_Secundum	0.56
fma:Superior_frontal_sulcus	nci:Superior_Frontal_Sulcus	0.5
fma:Cardiac_ventricle	nci:Cardiac_Ventricle	0.65
fma:Uracil	nci:Uracil	0.56
fma:Isthmus_of_hair_follicle	nci:Hair_Follicle_Isthmus	0.55
fma:Lower_jaw	nci:Lower_Jaw	0.61
fma:Inferior_frontal_sulcus	nci:Inferior_Frontal_Sulcus	0.5
fma:Skeletal_muscle_tissue	nci:Skeletal_Muscle_Tissue	0.53
fma:Ileum	nci:Ileum	0.56
fma:Floor_of_mouth	nci:Floor_of_the_Mouth	0.56
fma:Orifice_of_auditory_tube	nci:Orifice_of_the_Eustachian_Tube	0.5
fma:Trigeminal_nuclear_complex	nci:Trigeminal_Nucleus	0.55
fma:Mammotroph	nci:Lactotroph_Cell	0.47
fma:Epithelium_of_gall_bladder	nci:Gallbladder_Epithelium	0.75
fma:Set_of_phalanges_of_foot	nci:Foot_Phalanx	0.53
fma:Suppressor_inducer_T_lymphocyte	nci:Suppressor-Inducer_T-Lymphocyte	0.6
fma:Ileal_diverticulum	nci:Meckel_Diverticulum	0.5
fma:Cell_to_matrix_adherens_junction	nci:Focal_Adhesion	0.18
fma:Popliteal_lymph_node	nci:Popliteal_Lymph_Node	0.66
fma:Apex_of_heart	nci:Apex_of_the_Heart	0.46
fma:Muscle_of_pharynx	nci:Pharyngeal_Muscle	0.82
fma:Intra_ocular_part_of_optic_nerve	nci:Optic_Disc	0.19
fma:Haploid_nucleated_cell	nci:Germ_Cell	0.8
fma:Serum	nci:Serum	0.6
fma:Set_of_ligaments	nci:Ligament	0.54
fma:Bulb_of_hair_follicle	nci:Hair_Bulb	0.55
fma:Splenic_vein	nci:Splenic_Vein	0.59
fma:Corneal_epithelium	nci:Corneal_Epithelium	0.74
fma:Glandular_cell_of_stomach	nci:Gastric_Glandular_Cell	0.78
fma:Root_of_thoracic_nerve	nci:Thoracic_Spinal_Nerve_Root	0.49
fma:Hepatopancreatic_ampulla	nci:Ampulla_of_Vater	0.55
fma:Set_of_carpal_bones	nci:Carpal_Bone	0.52
fma:Integumentary_system	nci:Integumentary_System	0.68
fma:Unmyelinated_nerve_fiber	nci:Unmyelinated_Nerve_Fiber	0.61
fma:Brachialis	nci:Brachialis	0.64
fma:Inferior_vesical_artery	nci:Inferior_Vesical_Artery	0.59
fma:Anterior_longitudinal_ligament	nci:Anterior_Longitudinal_Ligament	0.6
fma:Pancreatic_islet	nci:Endocrine_Pancreas	0.11
fma:Set_of_joints	nci:Joint	0.71
fma:Outer_layer_of_endometrium	nci:Functional_Layer_of_the_Endometrium	0.53
fma:Right_lobe_of_thyroid_gland	nci:Right_Thyroid_Gland_Lobe	0.59
fma:Myenteric_nerve_plexus	nci:Myenteric_Nerve_Plexus	0.61
fma:Oropharynx	nci:Oropharynx	0.56
fma:Xiphoid_process	nci:Xiphoid_Process	0.55
fma:Thoracic_aorta	nci:Thoracic_Aorta	0.59
fma:External_pyramidal_layer_of_neocortex	nci:External_Pyramidal_Cell_Layer	0.54
fma:Neuroglial_cell	nci:Glial_Cell	0.7
fma:Glomerular_mesangium	nci:Mesangium	0.38
fma:Posterior_meningeal_artery	nci:Posterior_Meningeal_Artery	0.57
fma:Buccal_artery	nci:Buccal_Artery	0.59
fma:Renshaw_cell	nci:Renshaw_Cell	0.8
fma:Cuneate_fasciculus_of_spinal_cord	nci:Tract_of_Burdach	0.46
fma:Set_of_openings_of_pulmonary_veins	nci:Opening_of_the_Pulmonary_Vein	0.42
fma:Set_of_muscles_of_tongue	nci:Tongue_Muscle	0.49
fma:Phalanx_of_finger	nci:Phalanx_of_the_Hand	0.5
fma:Glans_penis	nci:Glans_Penis	0.55
fma:Epithelium_of_conjunctiva	nci:Conjunctival_Epithelium	0.7
fma:Mechanoreceptor	nci:Mechanoreceptor_Cell	0.5
fma:Median_lobe_of_prostate	nci:Middle_Lobe_of_the_Prostate	0.52
fma:Ovarian_cortex	nci:Ovarian_Cortex	0.55
fma:Intestinal_secretion	nci:Intestinal_Secretion	0.57
fma:Right_lower_first_secondary_molar_tooth	nci:Tooth_30	0.51
fma:Ostium_of_inferior_vena_cava	nci:Inferior_Vena_Cava_Opening	0.48
fma:Transverse_colon	nci:Transverse_Colon	0.55
fma:Set_of_superior_vesical_arteries	nci:Superior_Vesical_Artery	0.53
fma:Central_retinal_vein	nci:Retinal_Vein	0.42
fma:Superior_suprarenal_artery	nci:Superior_Suprarenal_Artery	0.57
fma:External_acoustic_tube	nci:External_Acoustic_Meatus	0.55
fma:Seminiferous_tubule_of_testis	nci:Seminiferous_Tubule	0.54
fma:Ascending_limb_of_loop_of_Henle	nci:Ascending_Limb_of_the_Henle_s_Loop	0.6
fma:Septal_leaflet_of_tricuspid_valve	nci:Septal_Cusp	0.53
fma:Thoracodorsal_artery	nci:Thoracodorsal_Artery	0.59
fma:Set_of_lingual_papillae	nci:Papilla_of_the_Tongue	0.28
fma:Portal_venous_system	nci:Portal_Venous_System	0.61
fma:Melatonin	nci:Melatonin	0.59
fma:Set_of_atlanto_axial_joints	nci:Atlanto-axial_Joint	0.55
fma:Minus_end_of_microtubule	nci:Minus_End_of_the_Microtubule	0.61
fma:Set_of_paranasal_sinuses	nci:Paranasal_Sinus_Retired	0.48
fma:Chromosome	nci:Chromosome	0.69
fma:Cell_junction	nci:Cell_Junction	0.76
fma:Deep_temporal_vein	nci:Deep_Temporal_Vein	0.58
fma:Bile	nci:Bile	0.57
fma:Facial_nucleus	nci:Facial_Nerve_Nucleus	0.57
fma:Ischium	nci:Ischium	0.54
fma:Vestibulocochlear_nerve	nci:Vestibulocochlear_Nerve	0.58
fma:Epithalamus	nci:Epithalamus	0.55
fma:Superior_temporal_gyrus	nci:Superior_Temporal_Gyrus	0.54
fma:Communicating_cell_junction	nci:Gap_Junction	0.62
fma:Monoblast	nci:Monoblast	0.64
fma:Ascending_colon	nci:Right_Colon	0.09
fma:Monocyte	nci:Monocyte	0.63
fma:Mental_artery	nci:Mental_Artery	0.59
fma:Appendicular_skeleton	nci:Appendicular_Skeleton	0.56
fma:Lentiform_nucleus	nci:Lenticular_Nucleus	0.59
fma:Dorsalis_pedis_artery	nci:Dorsalis_Pedis_Artery	0.54
fma:Eccrine_sweat_gland	nci:Eccrine_Sweat_Gland	0.61
fma:Portion_of_plasma	nci:Plasma	0.45
fma:Neck_of_urinary_bladder	nci:Bladder_Neck	0.56
fma:Mucosa_of_upper_lip	nci:Mucosa_of_the_Upper_Lip	0.58
fma:Protoplasm	nci:Protoplasm	0.53
fma:Superior_part_of_duodenum	nci:First_Portion_of_the_Duodenum	0.56
fma:Maxillary_sinus	nci:Maxillary_Sinus	0.56
fma:Masseteric_vein	nci:Masseteric_Vein	0.58
fma:Inferior_vestibular_nucleus	nci:Spinal_Vestibular_Nucleus	0.63
fma:Bone_of_pubis	nci:Pubic_Bone	0.42
fma:Vestibulocochlear_organ	nci:Ear	0.19
fma:Triceps_brachii	nci:Triceps	0.53
fma:Histone_H1	nci:Histone-H1	0.64
fma:Peduncle_of_midbrain	nci:Cerebral_Peduncle	0.55
fma:Body_of_pancreas	nci:Body_of_the_Pancreas	0.55
fma:Ligament	nci:Ligament	0.5
fma:Troponin_T	nci:Troponin_T	0.5
fma:Diaphragm	nci:Diaphragm	0.73
fma:Duct_of_sebaceous_gland	nci:Sebaceous_Gland_Duct	0.55
fma:Pharynx	nci:Pharynx	0.56
fma:Chondrocranium	nci:Chondrocranium	0.56
fma:Free_border_of_nail	nci:Free_Edge_of_the_Nail	0.2
fma:Serine	nci:Serine	0.55
fma:Scaphoid	nci:Scaphoid_Bone	0.61
fma:Cusp_of_cardiac_valve	nci:Cardiac_Valve_Cusp	0.54
fma:Pigmented_layer_of_retina	nci:Retinal_Pigment_Epithelium	0.59
fma:Axillary_artery	nci:Axillary_Artery	0.58
fma:Cardiac_vein	nci:Cardiac_Vein	0.66
fma:Intercalated_duct_of_pancreas	nci:Intercalated_Duct_of_the_Pancreas	0.73
fma:Tensor_tympani	nci:Tensor_Tympani	0.62
fma:Intermediate_filament	nci:Intermediate_Filament	0.71
fma:Iliopsoas	nci:Iliopsoas_Muscle	0.48
fma:Segmental_bronchus	nci:Segmental_Bronchus	0.53
fma:Tragus	nci:Tragus	0.54
fma:Substantia_nigra	nci:Substantia_Nigra	0.56
fma:Intercalated_cell_of_collecting_duct_of_renal_tubule	nci:Type_I_Cell	0.71
fma:Granulosa_lutein_cell	nci:Granulosa_Lutein_Cell	0.63
fma:Set_of_interlobular_bile_ducts	nci:Interlobular_Bile_Duct	0.55
fma:Axillary_tail_of_breast	nci:Axillary_Tail_of_the_Breast	0.56
fma:Type_1_muscle_cell	nci:Muscle_Fibers_Slow-Twitch	0.54
fma:Intestinal_epithelium	nci:Intestinal_Epithelium	0.7
fma:Ciliated_columnar_cell_of_tracheobronchial_tree	nci:Ciliated_Bronchial_Epithelial_Cell	0.71
fma:Carpal_bone	nci:Carpus_Bone	0.51
fma:Skin_of_face	nci:Skin_of_the_Face	0.65
fma:Skeletal_muscle_cell	nci:Skeletal_Muscle_Cell	0.83
fma:Clear_cell	nci:Clear_Cell	0.5
fma:Kidney	nci:Kidney	0.72
fma:Thoracic_wall	nci:Chest_Wall	0.07
fma:Vertebral_column	nci:Vertebral_Column	0.56
fma:Left_subcostal_vein	nci:Left_Subcostal_Vein	0.64
fma:Right_kidney	nci:Right_Kidney	0.68
fma:Centromere	nci:Centromere	0.59
fma:Hindgut	nci:Hindgut	0.56
fma:Deep_circumflex_iliac_artery	nci:Deep_Circumflex_Iliac_Artery	0.66
fma:Left_uterine_tube	nci:Left_Fallopian_Tube	0.66
fma:Muscularis_mucosae_of_stomach	nci:Gastric_Muscularis_Mucosa	0.57
fma:Small_saphenous_vein	nci:Short_Saphenous_Vein	0.54
fma:Sinusoid	nci:Discontinuous_Capillary	0.54
fma:Right_lobe_of_liver	nci:Right_Lobe_of_the_Liver	0.58
fma:Mesothelial_cell_of_peritoneum	nci:Peritoneal_Mesothelial_Cell	0.72
fma:Spermatogonium	nci:Spermatogonium	0.72
fma:Type_I_alveolar_epithelial_cell	nci:Squamous_Alveolar_Lining_Cell	0.74
fma:Specialized_epithelial_cell	nci:Specialized_Epithelial_Cell	0.5
fma:External_supporting_cell_of_organ_of_Corti	nci:Supporting_Cell_of_Organ_of_Corti	0.6
fma:Angular_gyrus	nci:Angular_Gyrus	0.54
fma:Mesothelial_cell	nci:Mesothelial_Cell	0.69
fma:Skin_of_abdomen	nci:Abdominal_Skin	0.64
fma:Olfactory_bulb	nci:Olfactory_Bulb	0.55
fma:Artery	nci:Artery	0.61
fma:Corneoscleral_junction	nci:Corneoscleral_Limbus	0.55
fma:Oocyte	nci:Oocyte	0.5
fma:Umbilical_artery	nci:Umbilical_Artery	0.55
fma:Bony_labyrinth	nci:Osseous_Labyrinth	0.54
fma:Myocardium	nci:Heart_Muscle	0.5
fma:Femur	nci:Femur	0.62
fma:Gustatory_pore	nci:Taste_Pore	0.5
fma:Thyro_arytenoid	nci:Thyroarytenoid_Muscle	0.61
fma:Medial_frontobasal_artery	nci:Medial_Orbitofrontal_Artery	0.62
fma:Composite	nci:Composite	0.5
fma:Keratan_sulfate	nci:Keratan_Sulfate	0.56
fma:Anterior_tibial_artery	nci:Anterior_Tibial_Artery	0.58
fma:Middle_colic_artery	nci:Middle_Colic_Artery	0.59
fma:Sciatic_nerve	nci:Sciatic_Nerve	0.57
fma:Ligamentum_flavum	nci:Ligamentum_Flavum	0.54
fma:Glandular_cell_of_esophagus	nci:Esophageal_Glandular_Cell	0.81
fma:Disaccharide	nci:Disaccharide	0.54
fma:Gonadotroph	nci:Gonadotrope_Cell	0.72
fma:Longus_capitis	nci:Longus_Capitis	0.59
fma:Glottis	nci:Glottis	0.56
fma:Embryonic_structure	nci:Embryonic_Structure	0.63
fma:Oogonium	nci:Primary_Oocyte	0.73
fma:Lactiferous_duct	nci:Lactiferous_Duct	0.6
fma:Lateral_meniscus	nci:Meniscus_Lateralis	0.58
fma:Gland	nci:Gland	0.5
fma:Blood_vessel_viewed_macroscopically	nci:Blood_Vessel	0.35
fma:Conus_medullaris	nci:Conus_Medullaris	0.55
fma:Myeloblast	nci:Myeloblast	0.64
fma:Patellar_ligament	nci:Patellar_Ligament	0.63
fma:Parafascicular_nucleus	nci:Parafascicular_Nucleus_of_the_Thalamus	0.57
fma:Set_of_lentiform_nuclei	nci:Lenticular_Nucleus	0.46
fma:Foam_cell	nci:Foamy_Macrophage	0.11
fma:Shoulder	nci:Shoulder	0.56
fma:Left_cerebral_hemisphere	nci:Left_Cerebral_Hemisphere	0.61
fma:Major_salivary_gland	nci:Major_Salivary_Gland	0.84
fma:Posterior	nci:Dorsal	0.0
fma:Medial_nuclear_group_of_thalamus	nci:Dorsomedial_Nucleus_of_the_Thalamus	0.57
fma:Sweat_gland_of_eyelid	nci:Gland_of_Moll	0.67
fma:Chiasmatic_cistern	nci:Chiasmatic_Cistern	0.56
fma:Gamma_tubulin	nci:Gamma-Tubulin	0.6
fma:Lobule	nci:Lobule	0.52
fma:Dorsal_part_of_foot	nci:Dorsal_Region_of_Foot	0.55
fma:Chromophobe_cell	nci:Chromophobe_Cell	0.5
fma:Proximal_phalanx_of_toe	nci:Proximal_Phalanx_of_Foot	0.53
fma:Common_carotid_artery	nci:Common_Carotid_Artery	0.65
fma:Vertebral_artery	nci:Vertebral_Artery	0.57
fma:Chief_cell	nci:Chief_Cell	0.5
fma:Proximal_phalanx_of_finger	nci:Proximal_Phalanx_of_Hand	0.61
fma:Mesangium	nci:Mesangium	0.56
fma:Set_of_seminiferous_tubules	nci:Seminiferous_Tubule	0.5
fma:Alveus_of_hippocampus	nci:Alveus	0.38
fma:Nucleus_ambiguus	nci:Nucleus_Ambiguus	0.59
fma:Cerebral_aqueduct	nci:Aqueduct_of_Sylvius	0.55
fma:Parietal_pleura	nci:Parietal_Pleura	0.55
fma:Skin_of_external_ear	nci:Ear_Skin	0.51
fma:Cerebral_vein	nci:Cerebral_Vein	0.64
fma:Internal_jugular_vein	nci:Internal_Jugular_Vein	0.58
fma:Urachus	nci:Urachus	0.57
fma:Lobar_bronchus	nci:Lobar_Bronchus	0.57
fma:Limb	nci:Limb	0.9
fma:Posterior_root_of_spinal_nerve	nci:Dorsal_Root_of_the_Spinal_Nerve	0.5
fma:Left_testis	nci:Left_Testis	0.68
fma:Esophagus	nci:Esophagus	0.65
fma:Photoreceptor_cell	nci:Photoreceptor_Cell	0.5
fma:Supramarginal_gyrus	nci:Supramarginal_Gyrus	0.54
fma:Ovary	nci:Ovary	0.67
fma:Glomerular_basement_membrane	nci:Glomerular_Basement_Membrane	0.56
fma:Longitudinal_fissure	nci:Longitudinal_Fissure	0.5
fma:Pericardial_artery	nci:Pericardiac_Artery	0.56
fma:White_matter_of_cerebellum	nci:Cerebellum_White_Matter	0.58
fma:Caproic_acid	nci:Caproic_Acid	0.5
fma:Antihemophilic_globulin	nci:Coagulation_Factor-VIII	0.5
fma:Oncocyte	nci:Oxyphil_Cell	0.68
fma:Muscle	nci:Muscle	0.5
fma:Beta_adrenergic_receptor	nci:Beta_Adrenergic_Receptor	0.56
fma:White_matter_of_spinal_cord	nci:White_Matter_of_the_Spinal_Cord	0.56
fma:Surface_of_bone	nci:Bone_Surface	0.51
fma:Bone_of_pisiform	nci:Pisiform_Bone	0.53
fma:Branch_of_posterior_cerebral_artery	nci:Posterior_Cerebral_Artery_Branch	0.73
fma:Fundus_of_stomach	nci:Fundus_of_the_Stomach	0.56
fma:Palate	nci:Palate	0.56
fma:Ciliary_muscle	nci:Ciliary_Muscle	0.54
fma:Left_brachiocephalic_vein	nci:Left_Brachiocephalic_Vein	0.55
fma:Femoral_vein	nci:Femoral_Vein	0.58
fma:Axodendritic_synapse	nci:Axodendritic_Synapse	0.66
fma:Stylopharyngeus	nci:Stylopharyngeus	0.66
fma:Superior	nci:Upper	0.09
fma:Parathyroid_gland	nci:Parathyroid_Gland	0.8
fma:Iliolumbar_artery	nci:Iliolumbar_Artery	0.58
fma:Acinar_cell	nci:Acinar_Cell	0.5
fma:Frontal_horn_of_lateral_ventricle	nci:Frontal_Horn_of_the_Lateral_Ventricle	0.53
fma:Depressor_labii_inferioris	nci:Depressor_Labii_Inferioris	0.67
fma:External_anal_sphincter	nci:External_Anal_Sphincter	0.63
fma:Microglial_cell	nci:Microglia	0.6
fma:Body_of_vertebra	nci:Vertebral_Body	0.52
fma:Endocrine_pancreas	nci:Endocrine_Pancreas	0.5
fma:Endothelium_of_artery	nci:Artery_Endothelium	0.61
fma:Hair_follicle	nci:Hair_Follicle	0.55
fma:Bulbus_cordis	nci:Bulbus_Cordis	0.64
fma:Deoxyribonucleic_acid	nci:Deoxyribonucleic_Acid	0.52
fma:Celiac_ganglion	nci:Coeliac_Ganglion	0.68
fma:Tarsal_bone	nci:Tarsal_Bone	0.74
fma:Unencapsulated_nerve_ending	nci:Free_Nerve_Ending	0.54
fma:Hilum_of_kidney	nci:Hilar_Area_of_the_Kidney	0.5
fma:Prepuce_of_penis	nci:Prepuce	0.55
fma:Pyloric_antrum	nci:Antrum_Pylori	0.56
fma:Pharyngeal_tonsil	nci:Pharyngeal_Tonsil	0.62
fma:Psoas_major	nci:Psoas_Major	0.57
fma:Stereocilium	nci:Stereocilium	0.54
fma:Type_D_cell_of_pancreatic_islet	nci:Delta_Cell_of_the_Pancreas	0.68
fma:Tail_of_spermatozoon	nci:Tail_of_the_Spermatozoon	0.53
fma:Anterior_segment_of_eyeball	nci:Anterior_Eye_Segment	0.55
fma:Set_of_medial_tarsal_arteries	nci:Medial_Tarsal_Artery	0.52
fma:Anterior_cerebral_artery	nci:Anterior_Cerebral_Artery	0.62
fma:Lumbar_nerve_plexus	nci:Lumbar_Plexus	0.58
fma:Glucagon_secreting_cell	nci:Alpha_Cell	0.5
fma:Endoderm	nci:Endoderm	0.63
fma:Set_of_fingers	nci:Finger	0.43
fma:Pulmonary_trunk	nci:Pulmonary_Artery	0.58
fma:Lunate_sulcus	nci:Lunate_Sulcus	0.5
fma:Cave_of_septum_pellucidum	nci:Fifth_Ventricle	0.5
fma:Mesangial_cell	nci:Mesangial_Cell	0.59
fma:Trabecula_of_spleen	nci:Splenic_Trabecula	0.55
fma:Cerebral_aqueduct	nci:Cerebral_Aqueduct	0.55
fma:Endocrine_gland	nci:Endocrine_Gland	0.56
fma:Occipital_horn_of_lateral_ventricle	nci:Occipital_Horn_of_the_Lateral_Ventricle	0.53
fma:Head_of_rib	nci:Rib_Head	0.52
fma:Abducens_nerve	nci:Abducens_Nerve	0.58
fma:Lamina_densa	nci:Lamina_Densa	0.56
fma:Scala_media	nci:Cochlear_Duct	0.14
fma:Atrioventricular_bundle	nci:Atrioventricular_Bundle	0.55
fma:Parasympathetic_ganglion	nci:Parasympathetic_Ganglion	0.65
fma:Postcapillary_venule	nci:Postcapillary_Venule	0.58
fma:Epididymis	nci:Epididymis	0.66
fma:Nasopharynx	nci:Nasopharynx	0.56
fma:Ejaculatory_duct	nci:Ejaculatory_Duct	0.71
fma:Gray_matter_of_spinal_cord	nci:Gray_Matter_of_the_Spinal_Cord	0.55
fma:Prepuce_of_penis	nci:Male_Prepuce	0.54
fma:Squamous_cell_of_ectocervix	nci:Ectocervical_Squamous_Cell	0.74
fma:Median_aperture_of_fourth_ventricle	nci:Magendie_s_Foramen	0.45
fma:Endothelium_of_venule	nci:Venule_Endothelium	0.64
fma:Atlanto_axial_joint	nci:Atlanto-axial_Joint	0.61
fma:Ganglioside	nci:Ganglioside	0.5
fma:Upper_lobe_of_right_lung	nci:Upper_Lobe_of_the_Right_Lung	0.62
fma:Pancreatic_tributary_of_splenic_vein	nci:Pancreatic_Vein	0.59
fma:Nonmembranous_cytoplasmic_organelle	nci:Nonmembranous_Cytoplasmic_Organelle	0.74
fma:Exocrine_gland	nci:Exocrine_Gland	0.55
fma:Fourth_ventricle	nci:Fourth_Ventricle_of_the_Brain	0.55
fma:Isoleucine	nci:Isoleucine	0.5
fma:Round_ligament_of_uterus	nci:Round_Ligament	0.59
fma:Set_of_accessory_lacrimal_glands	nci:Gland_of_Wolfring	0.56
fma:Heparan_sulfate_proteoglycan	nci:Heparan_Sulfate_Proteoglycan	0.5
fma:Cerebellomedullary_cistern	nci:Cisterna_Magna	0.56
fma:Posterior_pole_of_lens	nci:Posterior_Pole_of_the_Lens	0.52
fma:Fascia_of_plantaris	nci:Plantar_Fascia	0.55
fma:Cochlear_nucleus	nci:Cochlear_Nuclei	0.49
fma:Omohyoid	nci:Omohyoid	0.63
fma:Nuclear_lamina	nci:Nuclear_Lamina	0.64
fma:CC_chemokine	nci:Beta_Chemokine	0.66
fma:Myofilament	nci:Myofilament	0.6
fma:Outside	nci:Outer	0.2
fma:Cuneiform_cartilage	nci:Cuneiform_Cartilage	0.64
fma:Synovial_fluid	nci:Synovial_Fluid	0.51
fma:Anterior_root_of_spinal_nerve	nci:Ventral_Nerve_Root	0.46
fma:Facial_artery	nci:Facial_Artery	0.63
fma:Tryptophan	nci:Tryptophan	0.5
fma:Glandular_cell_of_small_intestine	nci:Small_Intestinal_Glandular_Cell	0.79
fma:Cricotracheal_ligament	nci:Cricotracheal_Ligament	0.64
fma:Interventricular_septum	nci:Interventricular_Septum	0.61
fma:Surface_of_prostate	nci:Surface_of_the_Prostate	0.53
fma:Splenius	nci:Splenius	0.56
fma:Adherens_junction	nci:Anchoring_Junction	0.73
fma:Humerus	nci:Humerus	0.62
fma:Gracilis	nci:Gracilis	0.63
fma:Cytoplasmic_organelle	nci:Cytoplasmic_Organelle	0.78
fma:Male_genital_system	nci:Male_Reproductive_System	0.73
fma:Head_of_femur	nci:Head_of_the_Femur	0.51
fma:Centrosome	nci:Centrosome	0.62
fma:Internal_iliac_artery	nci:Internal_Iliac_Artery	0.57
fma:Faucial_pillar	nci:Tonsillar_Pillar	0.09
fma:Collagen_fibril	nci:Collagen_Fiber	0.48
fma:Stem_cell	nci:Stem_Cell	0.69
fma:Utriculosaccular_duct	nci:Utriculosaccular_Duct	0.55
fma:Rete_testis	nci:Rete_Testis	0.55
fma:Basal_cell_of_olfactory_epithelium	nci:Olfactory_Basal_Cell	0.77
fma:Mononuclear_phagocyte_system	nci:Reticuloendothelial_System	0.5
fma:Middle_mediastinum	nci:Middle_Mediastinum	0.56
fma:Alimentary_system	nci:Gastrointestinal_System	0.68
fma:Stromal_cell_of_endometrium	nci:Endometrial_Stromal_Cell	0.59
fma:Peripheral_nervous_system	nci:Peripheral_Nervous_System	0.5
fma:Inferior_pancreaticoduodenal_artery	nci:Inferior_Pancreatico-duodenal_artery	0.63
fma:Olfactory_receptor_cell	nci:Olfactory_Receptor_Neuron	0.55
fma:Muscle_spindle	nci:Muscle_Spindle	0.56
fma:Tongue	nci:Tongue	0.56
fma:Cricopharyngeus	nci:Cricopharyngeus_Muscle	0.53
fma:Cytotrophoblast	nci:Cytotrophoblast	0.64
fma:Reticulin_fiber	nci:Reticular_Fiber	0.5
fma:Synapse	nci:Synapse	0.74
fma:Melatonin	nci:Therapeutic_Melatonin	0.56
fma:Bronchopulmonary_lymph_node	nci:Bronchial_Lymph_Node	0.55
fma:Facial_vein	nci:Facial_Vein	0.58
fma:Megakaryoblast	nci:Megakaryoblast	0.64
fma:Membrane_of_mitochondrion	nci:Mitochondrial_Membrane	0.72
fma:Striated_muscle_tissue	nci:Striated_Muscle_Tissue	1.0
fma:Left_ventricle	nci:Left_Ventricle	0.61
fma:Head_of_pancreas	nci:Head_of_the_Pancreas	0.55
fma:Bone	nci:Bone	0.52
fma:Median_artery	nci:Median_Artery	0.6
fma:Lobe_of_thyroid_gland	nci:Thyroid_Gland_Lobe	0.67
fma:Medial_forebrain_bundle	nci:Medial_Forebrain_Bundle	0.55
fma:Early_endosome	nci:Early_Endosome	0.8
fma:Main_submandibular_duct	nci:Submandibular_Duct	0.64
fma:Epithelium_of_esophagus	nci:Esophageal_Epithelium	0.62
fma:Buccal_part_of_mouth	nci:Cheek	0.05
fma:Renal_tubule	nci:Renal_Tubule	0.53
fma:Medial_rectus	nci:Medial_Rectus_Muscle	0.6
fma:Apex_of_tongue	nci:Apex_of_the_Tongue	0.56
fma:Lymphatic_capillary	nci:Lymphatic_Capillary	0.6
fma:Right_cerebral_hemisphere	nci:Right_Cerebral_Hemisphere	0.61
fma:Body_of_stomach	nci:Body_of_Stomach	0.56
fma:Trapezoid	nci:Trapezoid_Bone	0.65
fma:Sphenoparietal_sinus	nci:Sphenoparietal_Sinus	0.55
fma:Gallbladder	nci:Gallbladder	0.65
fma:Set_of_tonsillar_crypts	nci:Tonsillar_Crypt	0.49
fma:Splenium_of_corpus_callosum	nci:Splenium_of_the_Corpus_Callosum	0.53
fma:Ganglionic_layer_of_retina	nci:Ganglion_Cell_Layer	0.6
fma:Secondary_tooth	nci:Permanent_Tooth	0.5
fma:Choroid	nci:Choroid	0.55
fma:Scalenus_medius	nci:Scalenus_Medius	0.63
fma:Supraclavicular_lymph_node	nci:Supraclavicular_Lymph_Node	0.72
fma:White_pulp_of_spleen	nci:Splenic_White_Pulp	0.59
fma:Posterior_surface_of_liver	nci:Posterior_Surface_of_the_Liver	0.54
fma:Posterior_wall_of_nasopharynx	nci:Posterior_Wall_of_the_Nasopharynx	0.56
fma:Centriole	nci:Centriole	0.73
fma:Pinealocyte	nci:Pinealocyte	0.74
fma:Pectineus	nci:Pectineus	0.63
fma:Platelet	nci:Platelet	0.61
fma:Set_of_zygapophysial_joints	nci:Facet_Joint	0.53
fma:Apex_of_prostate	nci:Apex_of_the_Prostate	0.52
fma:Notochord	nci:Notochord	0.64
fma:Right_adrenal_gland	nci:Right_Adrenal_Gland	0.66
fma:Left_inguinal_part_of_abdomen	nci:Left_Inguinal_Region	0.61
fma:Set_of_renal_medullae	nci:Renal_Medulla	0.49
fma:Plus_end_of_actin_filament	nci:Plus_End_of_the_Actin_Filament	0.62
fma:Transitional_epithelium_of_urinary_bladder	nci:Bladder_Transitional_Cell_Epithelium	0.7
fma:Posterior_parietal_artery	nci:Posterior_Parietal_Artery	0.62
fma:Semicircular_duct	nci:Semicircular_Duct	0.53
fma:Subcostal_artery	nci:Subcostal_Artery	0.57
fma:Posterior_cruciate_ligament	nci:Posterior_Cruciate_Ligament	0.63
fma:Subiculum	nci:Subiculum	0.55
fma:Epithelium_of_choroid_plexus_of_lateral_ventricle	nci:Choroid_Plexus_Epithelium_of_the_Lateral_Ventricle	0.59
fma:Axosomatic_synapse	nci:Axosomatic_Synapse	0.66
fma:Mesothelial_cell_of_pleura	nci:Pleural_Mesothelial_Cell	0.72
fma:Wall_of_organelle	nci:Intracellular_Membrane	0.57
fma:Minor_salivary_gland	nci:Minor_Salivary_Gland	0.78
fma:Submucosa_of_stomach	nci:Gastric_Submucosa	0.61
fma:Ophthalmic_nerve	nci:Ophthalmic_Nerve	0.57
fma:Plus_end_of_microtubule	nci:Plus_End_of_the_Microtubule	0.61
fma:Female_urethra	nci:Female_Urethra	0.7
fma:Elastin_fiber	nci:Elastin_Fiber	0.56
fma:Lactiferous_terminal_ductal_lobular_unit	nci:Terminal_Ductal_Lobular_Unit	0.55
fma:Arch_of_aorta	nci:Aortic_Arch	0.55
fma:Crypt_of_Lieberkuhn	nci:Crypts_of_the_Lieberkuhn	0.64
fma:Longissimus_thoracis	nci:Longissimus_Thoracis	0.59
fma:External_supporting_cell_of_organ_of_Corti	nci:Outer_Supporting_Cell	0.61
fma:Ulnar_nerve	nci:Ulnar_Nerve	0.57
fma:Trochanter	nci:Trochanter	0.55
fma:Smegma	nci:Smegma	0.58
fma:Chief_cell_of_parathyroid_gland	nci:Parathyroid_Gland_Chief_Cell	0.65
fma:Costodiaphragmatic_recess	nci:Costophrenic_Angle	0.5
fma:Spinal_epidural_space	nci:Epidural_Spinal_Canal_Space	0.5
fma:Right_coronary_artery	nci:Right_Coronary_Artery	0.63
fma:Cricoid_cartilage	nci:Cricoid_Cartilage	0.65
fma:Synovial_bursa	nci:Synovial_Bursa	0.51
fma:Synovial_joint_of_pelvic_girdle	nci:Joint_of_the_Pelvic_Girdle	0.56
fma:Carbohydrate	nci:Carbohydrate	0.62
fma:Inferolateral_surface_of_prostate	nci:Inferolateral_Surface_of_the_Prostate	0.54
fma:Follicle_of_ovary	nci:Ovarian_Follicle	0.72
fma:Submandibular_gland	nci:Submandibular_Gland	0.67
fma:Interdigitating_dendritic_cell	nci:Interdigitating_Dendritic_Cell	0.64
fma:Right_mammary_gland	nci:Right_Breast	0.17
fma:Peripheral_nerve	nci:Peripheral_Nerve	0.64
fma:Polysaccharide	nci:Polysaccharide	0.54
fma:Cone	nci:Cone_Shape	0.5
fma:Exon	nci:Exon	0.55
fma:Vimentin	nci:Vimentin_Protein	0.67
fma:Photoreceptor_layer_of_retina	nci:Layer_of_the_Rods_and_Cones	0.62
fma:Set_of_lens_fibers	nci:Lens_Fiber	0.48
fma:Endocervix	nci:Endocervix	0.55
fma:Submental_vein	nci:Submental_Vein	0.58
fma:Set_of_lymph_nodes_of_neck	nci:Cervical_Lymph_Node	0.3
fma:Basal_lamina	nci:Basal_Lamina	0.53
fma:Cartilage_of_cuneiform_bone	nci:Cuneiform_Cartilage	0.57
fma:Large_intestine	nci:Large_Intestine	0.56
fma:Heart	nci:Heart	0.65
fma:Oxyphil_cell	nci:Oxyphil_Cell	0.5
fma:Nephrogenic_cord	nci:Nephrogenic_Cord	0.64
fma:Adipocyte	nci:Lipocyte	0.68
fma:Aponeurosis	nci:Aponeurosis	0.51
fma:Ciliary_process	nci:Ciliary_Process	0.55
fma:Enterocyte	nci:Enterocyte	0.62
fma:Scalene_muscle	nci:Scalene_Muscle	0.6
fma:Intercalated_cell_of_collecting_duct_of_renal_tubule	nci:Intercalated_Cell	0.5
fma:Set_of_semicircular_ducts	nci:Semicircular_Duct	0.54
fma:Enteric_ganglion	nci:Enteric_Ganglion	0.64
fma:Talus	nci:Talus	0.61
fma:Spinal_dura_mater	nci:Spinal_Cord_Dura_Mater	0.56
fma:Adipose_tissue	nci:Adipose_Tissue	0.64
fma:Cytosine	nci:Cytosine	0.56
fma:White_matter_of_neuraxis	nci:White_Matter	0.59
fma:Bone_of_trapezium	nci:Trapezial_Bone	0.47
fma:Nerve	nci:Nerve	0.58
fma:Set_of_lobules_of_liver	nci:Hepatic_Lobule	0.41
fma:Female_genital_system	nci:Female_Genitalia	0.53
fma:Ureter	nci:Ureter	0.74
fma:Secretory_granule	nci:Secretory_Vesicle	0.36
fma:Anterior_wall_of_urinary_bladder	nci:Anterior_Wall_of_the_Bladder	0.51
fma:Lacrimal_bone	nci:Lacrimal_Bone	0.58
fma:Loose_connective_tissue	nci:Loose_Connective_Tissue	0.57
fma:Body_of_penis	nci:Body_of_the_Penis	0.55
fma:Late_endosome	nci:Late_Endosome	0.8
fma:Neck_of_tooth	nci:Collum_Dentis	0.5
fma:Cellulose	nci:Cellulose	0.59
fma:Nail	nci:Nail	0.71
fma:Intrahepatic_bile_duct	nci:Intrahepatic_Bile_Duct	0.63
fma:Skin_of_limb	nci:Skin_of_the_Extremity	0.29
fma:Set_of_sebaceous_glands	nci:Sebaceous_Gland	0.55
fma:Isthmus_of_thyroid_gland	nci:Thyroid_Gland_Isthmus	0.55
fma:Structural_gene	nci:Structural_Gene	0.5
fma:Posterior_commissure	nci:Posterior_Commissure	0.55
fma:Superior_vesical_artery	nci:Superior_Vesical_Artery	0.59
fma:Brain	nci:Brain	0.55
fma:Bone_of_vertebra	nci:Vertebral_Bone	0.46
fma:Peroneal_artery	nci:Peroneal_Artery	0.58
fma:Cell_adhesion_molecule	nci:Cell_Adhesion_Molecule	0.63
fma:Auditory_system	nci:Auditory_System	0.5
fma:Wall_of_body_of_uterus	nci:Wall_of_Body_of_Uterus	0.56
fma:Phenylalanine	nci:Phenylalanine	0.5
fma:Insula	nci:Central_Lobe	0.54
fma:Ventral_corticospinal_tract	nci:Direct_Pyramidal_Tract	0.31
fma:B_lymphoblast	nci:B-Lymphoblast	0.56
fma:Lacrimal_canaliculus	nci:Lacrimal_Canaliculus	0.55
fma:Mucosa	nci:Mucous_Membrane	0.5
fma:Olfactory_epithelial_cell	nci:Olfactory_Epithelial_Cell	0.77
fma:Eotaxin	nci:Small_Inducible_Cytokine-A11	0.71
fma:Occipital_lobe	nci:Occipital_Lobe	0.54
fma:Biceps_brachii	nci:Biceps	0.57
fma:Right_testis	nci:Right_Testis	0.68
fma:Androgen	nci:Androgen	0.59
fma:Mastoid_process	nci:Mastoid_Process	0.54
fma:Choroid_plexus_of_fourth_ventricle	nci:Choroid_Plexus_of_the_Fourth_Ventricle	0.53
fma:Anus	nci:Anal	0.36
fma:Mesenchymal_cell	nci:Mesenchymal_Stem_Cell	0.53
fma:Set_of_lentiform_nuclei	nci:Lentiform_Nucleus	0.46
fma:Enteroendocrine_cell	nci:Endocrine_Cell_of_the_Gastrointestinal_System	0.75
fma:Brachiocephalic_vein	nci:Innominate_Vein	0.65
fma:Superior_rectal_artery	nci:Superior_Hemorrhoidal_Artery	0.59
fma:Vertical	nci:Vertical	0.5
fma:Deep_vein	nci:Deep_Vein	0.5
fma:Mitotic_chromosome	nci:Mitotic_Chromosome	0.6
fma:Otolith	nci:Otolith	0.56
fma:Vitelline_vein	nci:Vitelline_Vein	0.61
fma:Trunk_of_nerve_to_psoas_minor	nci:Phagosome	0.04
fma:Somatic_nerve_plexus	nci:Spinal_Nerve_Plexus	0.69
fma:Ciliary_body	nci:Ciliary_Body	0.55
fma:Arteriole	nci:Arteriole	0.54
fma:Ependyma_of_neuraxis	nci:Ependyma	0.62
fma:Oligosaccharide	nci:Oligosaccharide	0.54
fma:Superior_mediastinum	nci:Superior_Mediastinum	0.56
fma:Subdivision_of_lamellar_bone	nci:Mature_Bone	0.33
fma:Smooth_muscle_tissue	nci:Smooth_Muscle_Tissue	0.59
fma:Arteriovenous_anastomosis	nci:Arteriovenous_Shunt	0.55
fma:Genioglossus	nci:Genioglossus	0.67
fma:Tubercle_of_rib	nci:Rib_Tubercle	0.52
fma:Anterior_meningeal_branch_of_anterior_ethmoidal_artery	nci:Anterior_Meningeal_Artery	0.54
fma:Epitympanic_recess	nci:Epitympanic_Recess	0.5
fma:Nucleoporin	nci:Nucleoporin	0.5
fma:Esophageal_gland	nci:Esophageal_Gland	0.61
fma:Infraclavicular_lymph_node	nci:Infraclavicular_Lymph_Node	0.59
fma:Heparan_sulfate	nci:Heparan_Sulfate	0.5
fma:Cortex_of_lymph_node	nci:Lymph_Node_Cortex	0.54
fma:Histone	nci:Histone	0.72
fma:Set_of_metacarpophalangeal_joints	nci:Metacarpophalangeal_Joint	0.54
fma:Nongranular_leukocyte	nci:Non-Granular_Leukocyte	0.52
fma:Stratified_cuboidal_epithelium	nci:Stratified_Cuboidal_Epithelium	0.67
fma:Stria_medullaris_of_fourth_ventricle	nci:Striae_Medullares	0.46
fma:Superior_gluteal_artery	nci:Gluteal_Artery	0.58
fma:Upper_lobe_of_lung	nci:Lung_Upper_Lobe	0.65
fma:Esophageal_artery	nci:Esophageal_Artery	0.57
fma:Mammillary_body	nci:Mamillary_Body	0.55
fma:Forebrain	nci:Prosencephalon	0.55
fma:Nail_of_finger	nci:Fingernail	0.56
fma:Set_of_phalanges_of_hand	nci:Hand_Phalanx	0.53
fma:Frontal_bone	nci:Frontal_Bone	0.64
fma:Layer_of_retina	nci:Retina_Layer	0.83
fma:Set_of_metatarsophalangeal_joints	nci:Metatarsophalangeal_Joint	0.54
fma:Glycine	nci:Glycine	0.55
fma:Pectoral_girdle	nci:Shoulder_Girdle	0.56
fma:Left_lobe_of_liver	nci:Left_Lobe_of_the_Liver	0.58
fma:Limb	nci:Extremities	0.51
fma:Band_cell	nci:Band_Cell	0.5
fma:Ameloblast	nci:Ameloblast	0.68
fma:Lung_parenchyma	nci:Lung_Tissue	0.51
fma:Head_of_spermatozoon	nci:Head_of_the_Spermatozoon	0.53
fma:Myometrium	nci:Myometrium	0.55
fma:Intron	nci:Intron	0.55
fma:Wall_of_endosome	nci:Membrane_of_the_Endosome	0.6
fma:Ovarian_medulla	nci:Ovarian_Medulla	0.55
fma:Histiocyte	nci:Histiocyte	0.59
fma:Tensor_fasciae_latae	nci:Tensor_Fasciae_Lata	0.58
fma:Distal_part_of_ileum	nci:Terminal_Ileum	0.55
fma:Set_of_tarsal_bones	nci:Tarsal_Bone	0.53
fma:Set_of_major_salivary_glands	nci:Major_Salivary_Gland	0.55
fma:Space_of_Mall	nci:Space_of_Mall	0.5
fma:Tentorium_cerebelli	nci:Tentorium_Cerebelli	0.56
fma:Vertebral_canal	nci:Vertebral_Canal	0.56
fma:Thorax	nci:Chest	0.55
fma:Upper_limb	nci:Arm	0.11
fma:Temporal_bone	nci:Temporal_Bone	0.62
fma:Hair_follicle	nci:Follicle	0.45
fma:Posterior_chamber_of_eyeball	nci:Posterior_Chamber_of_the_Eye	0.59
fma:Transverse_fold_of_rectum	nci:Transverse_Rectal_Fold	0.55
fma:Purkinje_neuron	nci:Purkinje_s_Cell	0.71
fma:Anocutaneous_line	nci:Anocutaneous_Line	0.5
fma:Temporomandibular_joint	nci:Jaw_Joint	0.62
fma:Sigmoid_colon	nci:Sigmoid_Colon	0.55
fma:Oxyntic_cell	nci:Parietal_Cell	0.79
fma:Knee_joint	nci:Knee_Joint	0.62
fma:Anal_sinus	nci:Anal_Sinus	0.5
fma:Muscularis_mucosae_of_large_intestine	nci:Large_Intestinal_Muscularis_Mucosa	0.56
fma:Semimembranosus	nci:Semimembranosus	0.63
fma:Trachea	nci:Trachea	0.68
fma:Pulmonary_acinus	nci:Pulmonary_Acinus	0.55
fma:Beta_cell	nci:Beta_Cell	0.5
fma:Arginine	nci:Arginine_Base	0.5
fma:Parietal_bone	nci:Parietal_Bone	0.63
fma:Ependyma_of_lateral_ventricle	nci:Lateral_Ventricle_Ependyma	0.52
fma:Right_ureter	nci:Right_Ureter	0.7
fma:Muscle_of_anterior_abdominal_wall	nci:Anterior_Abdominal_Wall_Muscle	0.62
fma:Distal_phalanx_of_finger	nci:Distal_Phalanx_of_Hand	0.61
fma:Autosome	nci:Autosome	0.61
fma:X_chromosome	nci:Chromosome_X	0.65
fma:Glandular_cell	nci:Glandular_Cell	0.5
fma:Interosseous_of_foot	nci:Foot_Interosseous_Muscle	0.63
fma:Microvillus	nci:Microvillus	0.55
fma:Set_of_cartilages	nci:Cartilagenous_Tissue	0.35
fma:Cervical_part_of_esophagus	nci:Cervical_Esophagus	0.56
fma:Set_of_renal_columns	nci:Cortical_Column	0.38
fma:Elbow_joint	nci:Elbow_Joint	0.62
fma:Thyroglossal_duct	nci:Thyroglossal_Duct	0.57
fma:Muscle_layer	nci:Muscularis_Propria	0.34
fma:Cecum	nci:Cecum	0.56
fma:Ear	nci:Ear	0.55
fma:Serous_membrane	nci:Serosa	0.51
fma:Base_of_prostate	nci:Base_of_the_Prostate	0.52
fma:Portal_lobule	nci:Portal_Lobule	0.55
fma:Levator_palpebrae_superioris	nci:Levator_Palpebrae_Superioris	0.66
fma:Collagen	nci:Collagen	0.86
fma:Lateral_occipital_sulcus	nci:Lateral-occipital_Sulcus	0.49
fma:Plasma_cell	nci:Plasma_Cell	0.63
fma:Set_of_paranasal_sinuses	nci:Paranasal_Sinus	0.5
fma:Hepatic_vein	nci:Hepatic_Vein	0.56
fma:Glutamine	nci:Glutamine	0.55
fma:Phagocyte	nci:Phagocytic_Cell	0.5
fma:Parametrium	nci:Parametrium	0.56
fma:Methionine	nci:Methionine	0.5
fma:Glutamic_acid	nci:Glutamic_Acid	0.55
fma:Sarcoplasm	nci:Sarcoplasm	0.55
fma:Adrenal_medulla	nci:Adrenal_Medulla	0.55
fma:Corticotroph	nci:Corticotroph_Cell	0.71
fma:Supraspinatus	nci:Supraspinatus	0.55
fma:Alveolar_duct	nci:Alveolar_Duct	0.55
fma:Axial_skeleton	nci:Axial_Skeleton	0.56
fma:Interphase_chromosome	nci:Interphase_Chromosome	0.6
fma:Cochlear_inner_hair_cell	nci:Inner_Hair_Cell_of_the_Organ_of_the_Corti	0.75
fma:Lower_limb	nci:Lower_Extremity	0.7
fma:Iliacus	nci:Iliacus	0.57
fma:Cell_nucleus	nci:Nucleus	0.55
fma:Skeletal_muscle_cell	nci:Skeletal_Fiber	0.6
fma:Central_sulcus	nci:Central_Sulcus_of_Rolando	0.5
fma:Soft_palate	nci:Soft_Palate	0.56
fma:Muscularis_mucosae_of_small_intestine	nci:Small_Intestinal_Muscularis_Mucosa	0.57
fma:Peduncle_of_midbrain	nci:Crus_Cerebri	0.31
fma:Hemidesmosome	nci:Hemidesmosome	0.73
fma:Inferior_epigastric_vein	nci:Deep_Epigastric_Vein	0.58
fma:Ligament_of_liver	nci:Liver_Ligament	0.55
fma:Nucleotide	nci:Nucleotides	0.5
fma:Musculature_of_neck	nci:Neck_Muscle	0.48
fma:Proline	nci:Proline	0.55
fma:Cavity_of_body_of_uterus	nci:Endometrial_Cavity	0.5
fma:Bronchus	nci:Bronchus	0.77
fma:Medial_plantar_artery	nci:Medial_Plantar_Artery	0.59
fma:Right_common_carotid_artery	nci:Right_Common_Carotid_Artery	0.63
fma:Left_ovary	nci:Left_Ovary	0.64
fma:Segment_of_aorta	nci:Aortic_Segment	0.91
fma:Supra_orbital_vein	nci:Supra-orbital_Vein	0.54
fma:Great_cerebral_vein	nci:Great_Cerebral_Vein_of_Galen	0.67
fma:Metacarpophalangeal_joint	nci:Metacarpophalangeal_Joint	0.57
fma:Secondary_dentition	nci:Permanent_Tooth	0.4
fma:Respiratory_system	nci:Respiratory_System	0.68
fma:Omentum	nci:Omentum	0.67
fma:Mandible	nci:Mandible	0.64
fma:High_densitiy_lipoprotein	nci:High_Density_Lipoprotein	0.57
fma:Vinculin	nci:Vinculin	0.63
fma:Alpha_adrenergic_receptor	nci:Alpha_Adrenergic_Receptor	0.5
fma:Incisor_tooth	nci:Incisor	0.64
fma:Incus	nci:Incus	0.59
fma:Set_of_splenic_trabeculae	nci:Splenic_Trabecula	0.5
fma:Prostatic_stroma	nci:Prostatic_Stroma	0.56
fma:Back_of_abdomen	nci:Lumbar_Region	0.55
fma:Chemokine	nci:Chemokine	0.6
fma:Internal_thoracic_artery	nci:Internal_Mammary_Artery	0.58
fma:Gluteus_maximus	nci:Gluteus_Maximus	0.59
fma:Duodenal_gland	nci:Brunner_s_Gland	0.62
fma:External	nci:Outer	0.09
fma:Thymic_vein	nci:Thymic_Vein	0.59
fma:Cell_body	nci:Perikaryon	0.54
fma:Lateral_vestibular_nucleus	nci:Lateral_Vestibular_Nucleus	0.67
fma:Trapezium	nci:Trapezial_Bone	0.65
fma:Set_of_pancreatic_islets	nci:Endocrine_Pancreas	0.22
fma:Threonine	nci:Threonine	0.5
fma:Caudal	nci:Caudad	0.43
fma:Gastrocnemius	nci:Gastrocnemius_Muscle	0.58
fma:Cochlear_nucleus	nci:Cochlear_Nucleus	0.53
fma:Falx_cerebri	nci:Falx_Cerebri	0.56
fma:Set_of_cranial_nerves	nci:Cranial_Nerve	0.51
fma:Commissure	nci:Commissure	0.52
fma:Sternum	nci:Sternum	0.64
fma:Caudal	nci:Caudal	0.5
fma:Mitochondrion	nci:Mitochondrion	0.71
fma:Pericallosal_artery	nci:Pericallosal_Artery	0.69
fma:Hematopoietic_system	nci:Hematopoietic_System	0.5
fma:Posterior_surface_of_stomach	nci:Posterior_Surface_of_the_Stomach	0.53
fma:Interstitial_cell_of_pineal_gland	nci:Interstitial_Cell_of_the_Pineal_Gland	0.58
fma:Visual_system	nci:Visual_Pathway	0.25
fma:Periosteal_dura	nci:Periosteal_Layer_of_the_Dura_Mater	0.53
fma:Glandular_cell_of_large_intestine	nci:Large_Intestinal_Glandular_Cell	0.79
fma:Prickle_cell_layer_of_epidermis	nci:Stratum_Spinosum	0.47
fma:Left_ureter	nci:Left_Ureter	0.7
fma:Skin_of_lip	nci:Skin_of_the_Lip	0.67
fma:Respiratory_bronchiole	nci:Respiratory_Bronchiole	0.6
fma:Diaphysis	nci:Diaphysis_of_the_Bone	0.41
fma:Axoaxonic_synapse	nci:Axoaxonic_Synapse	0.66
fma:Pelvic_lymph_node	nci:Pelvic_Lymph_Node	0.56
fma:Left_renal_vein	nci:Left_Renal_Vein	0.64
fma:Set_of_foliate_papillae	nci:Foliate_Papilla	0.54
fma:Trigeminal_motor_nucleus	nci:Motor_Nucleus_of_the_Trigeminal_Nerve	0.57
fma:Pisiform	nci:Pisiform_Bone	0.61
fma:Submandibular_duct	nci:Submandibular_Duct	0.62
fma:Mucosa_of_urinary_bladder	nci:Bladder_Mucosa	0.6
fma:Crico_oesophageal_tendon	nci:Cricoesophageal_Tendon	0.54
fma:Salivary_gland	nci:Salivary_Gland	0.83
fma:Chromaffin_cell	nci:Chromaffin_Cell	0.61
fma:Mannose	nci:Mannose	0.59
fma:Umbilical_cord	nci:Umbilical_Cord	0.65
fma:Palatine_bone	nci:Palatine_Bone	0.66
fma:Aqueous_humor_of_eyeball	nci:Aqueous_Humor	0.58
fma:Branch_of_vertebral_artery	nci:Vertebral_Artery_Branch	0.66
fma:Glandular_cell_of_endometrium	nci:Endometrial_Cell	0.74
fma:Ovarian_vein	nci:Ovarian_Vein	0.58
fma:Leg	nci:Leg	0.55
fma:Cortex_of_thymus	nci:Thymus_Cortex	0.56
fma:Common_iliac_vein	nci:Common_Iliac_Vein	0.57
fma:Central_retinal_artery	nci:Retinal_Artery	0.59
fma:Extracellular_space	nci:Extracellular_Space	0.5
fma:Mitochondrial_deoxyribonucleic_acid	nci:Mitochondrial_DNA	0.56
fma:Internal_anal_sphincter	nci:Internal_Anal_Sphincter	0.55
fma:Steroid_hormone	nci:Therapeutic_Steroid_Hormone	0.54
fma:Distal_phalanx_of_finger	nci:Distal_Phalanx_of_the_Hand	0.5
fma:Set_of_ciliary_glands	nci:Gland_of_Moll	0.42
fma:Tectal_plate	nci:Corpora_Quadrigemina	0.35
fma:Set_of_bursae	nci:Synovial_Bursa	0.2
fma:Thoracic_vertebral_column	nci:Thoracic_Spine	0.55
fma:Transitional_epithelium	nci:Transitional_Epithelium	0.68
fma:External_granular_layer_of_cerebral_cortex	nci:External_Granular_Layer	0.53
fma:Set_of_circular_folds_of_small_intestine	nci:Valve_of_Kerckring	0.41
fma:Head_of_epididymis	nci:Head_of_the_Epididymis	0.52
fma:Bronchiole	nci:Bronchiole	0.6
fma:Pillar_cell_of_cochlea	nci:Pillar_Cell	0.6
fma:Acromioclavicular_joint	nci:Acromioclavicular_Joint	0.62
fma:Epithelial_cell_of_renal_tubule	nci:Renal_Cell	0.7
fma:Cartilage_tissue	nci:Cartilagenous_Tissue	0.72
fma:Endosteal_cell	nci:Endosteal_Cell	0.6
fma:Inferior_oblique	nci:Inferior_Oblique_Muscle	0.61
fma:Valine	nci:Valine	0.5
fma:Lymph	nci:Lymph	0.56
fma:Dopamine	nci:Dopamine	0.5
fma:Premolar_tooth	nci:Bicuspid_Tooth	0.56
fma:Erythroid_progenitor_cell	nci:Erythroid_Progenitor_Cell	0.62
fma:Lateral_ventricle	nci:Lateral_Ventricle	0.54
fma:Tibial_collateral_ligament	nci:Medial_Collateral_Ligament_of_the_Knee	0.43
fma:Oligodendrocyte	nci:Oligodendroglia_Cell	0.71
fma:Set_of_nares	nci:Nostril	0.48
fma:Helix	nci:Helix	0.54
fma:Brainstem	nci:Brain_Stem	0.55
fma:Head_of_humerus	nci:Head_of_the_Humerus	0.51
fma:Pancreatic_juice	nci:Pancreatic_Secretion	0.56
fma:Superficial	nci:Superficial	0.5
fma:Prostatic_capsule	nci:Prostate_Capsule	0.47
fma:Uncinate_process_of_pancreas	nci:Uncinate_Pancreas	0.55
fma:Skin_of_ankle	nci:Ankle_Skin	0.62
fma:Syncytiotrophoblast_cell	nci:Syncytiotrophoblastic_Cell	0.66
fma:Right_testicular_vein	nci:Right_Spermatic_Vein	0.63
fma:Thalamus	nci:Thalamus	0.54
fma:Kinocilium	nci:Kinocilium	0.55
fma:Sympathetic_ganglion	nci:Sympathetic_Ganglion	0.79
fma:Hippocampus	nci:Cornu_Ammonis	0.55
fma:Superior	nci:Superior	0.5
fma:Middle_part_of_external_acoustic_tube	nci:Pars_Media	0.53
fma:Set_of_thoracic_ganglia	nci:Thoracic_Ganglion	0.51
fma:Lymphokine	nci:Lymphokine	0.63
fma:Endoplasmic_reticulum	nci:Endoplasmic_Reticulum	0.74
fma:Ostium_of_superior_vena_cava	nci:Superior_Vena_Cava_Opening	0.48
fma:Primary_tooth	nci:Temporary_Tooth	0.5
fma:Set_of_cartilages	nci:Cartilage	0.66
fma:Set_of_coronary_arteries	nci:Coronary_Artery	0.56
fma:Hamate	nci:Hamate_Bone	0.65
fma:Lipoblast	nci:Lipoblast	0.56
fma:Ileocolic_artery	nci:Ileo-colic_Artery	0.63
fma:Erythroblast	nci:Erythroblast	0.7
fma:Pharyngotympanic_tube	nci:Eustachian_Tube	0.55
fma:Medial_tarsal_artery	nci:Medial_Tarsal_Artery	0.56
fma:Styloglossus	nci:Styloglossus	0.67
fma:Trigone_of_urinary_bladder	nci:Bladder_Trigone	0.56
fma:Anterior_inferior_cerebellar_artery	nci:Anterior_Inferior_Cerebellar_Artery	0.62
fma:Triangular_part_of_inferior_frontal_gyrus	nci:Triangular_Part_of_the_Inferior_Frontal_Gyrus	0.53
fma:Estrogen	nci:Therapeutic_Estrogen	0.46
fma:Interosseous_muscle_of_hand	nci:Hand_Interosseous_Muscle	0.61
fma:Ganglion	nci:Ganglion	0.9
fma:Common_fibular_nerve	nci:Peroneal_Nerve	0.52
fma:Nasal_concha	nci:Nasal_Turbinate	0.53
fma:Set_of_dorsal_metacarpal_arteries	nci:Dorsal_Metacarpal_Artery	0.53
fma:Dorsal_interosseous_of_hand	nci:Dorsal_Hand_Interosseous_Muscle	0.56
fma:Internal_carotid_artery	nci:Internal_Carotid_Artery	0.57
fma:Set_of_masticatory_muscles	nci:Muscle_of_the_Mastication	0.4
fma:Vascular_layer_of_eyeball	nci:Uvea	0.53
fma:Vitreous_chamber_of_eyeball	nci:Vitreous_Chamber	0.59
fma:Lacrimal_apparatus	nci:Lacrimal_Apparatus	0.55
fma:Latissimus_dorsi	nci:Musculus_Latissimus_Dorsi	0.59
fma:Glycoprotein	nci:Glycoprotein	0.5
fma:Carotid_body	nci:Carotid_Body	0.55
fma:Superior_sagittal_sinus	nci:Superior_Sagittal_Sinus	0.6
fma:Epithelium_of_nasopharynx	nci:Nasopharynx_Epithelium	0.7
fma:Endothelium_of_arteriole	nci:Arteriole_Endothelium	0.64
fma:Corniculate_cartilage	nci:Corniculate_Cartilage	0.64
fma:Merkel_cell	nci:Merkel_Cell	0.72
fma:Neck	nci:Neck	0.57
fma:Anterior_cranial_fossa	nci:Anterior_Fossa	0.5
fma:Delta_cell	nci:Delta_Cell	0.5
fma:Pluripotent_stem_cell	nci:Pluripotent_Stem_Cell	0.65
fma:Pericardial_cavity	nci:Pericardial_Cavity	0.56
fma:Central_sulcus	nci:Fissure_of_Rolando	0.5
fma:Aryepiglotticus	nci:Aryepiglottic_Muscle	0.58
fma:Body_of_nail	nci:Body_of_the_Nail	0.48
fma:Promyelocyte	nci:Promyelocyte	0.64
fma:Monocyte_chemoattractant_protein_3	nci:Small_Inducible_Cytokine-A7	0.71
fma:Muscle_layer_of_small_intestine	nci:Small_Intestinal_Muscular_Coat	0.49
fma:Nuclear_membrane	nci:Nuclear_Membrane	0.61
fma:Sacro_iliac_joint	nci:Sacroiliac_Joint	0.62
fma:Palatine_tonsil	nci:Palatine_Tonsil	0.61
fma:Flatulence	nci:Flatulence	0.5
fma:Lymphoblast	nci:Lymphoblast	0.65
fma:Upper_gastrointestinal_tract	nci:Upper_Gastrointestinal_Tract	0.62
fma:Median_nerve	nci:Median_Nerve	0.57
fma:Upper_jaw	nci:Upper_Jaw	0.61
fma:Superficial_fascia	nci:Subcutis	0.54
fma:Epigastrium	nci:Epigastric_Region	0.56
fma:Eye	nci:Eye	0.55
fma:Descending_part_of_duodenum	nci:Second_Portion_of_the_Duodenum	0.56
fma:Pylorus	nci:Pylorus	0.56
fma:Cilium	nci:Cilium	0.53
fma:Rectus_abdominis	nci:Rectus_Abdominis	0.66
fma:Mucosa_of_large_intestine	nci:Large_Intestinal_Mucosa	0.59
fma:Extrahepatic_biliary_tree	nci:Extrahepatic_Bile_Duct	0.46
fma:Ligamentum_teres_of_liver	nci:Round_Ligament_of_the_Liver	0.53
fma:Lung	nci:Lung	0.72
fma:Parotid_duct	nci:Parotid_Duct	0.65
fma:Trunk_of_left_pulmonary_artery	nci:Left_Pulmonary_Artery	0.57
fma:Seminal_vesicle	nci:Seminal_Vesicle	0.56
fma:Phrenic_artery	nci:Phrenic_Artery	0.59
fma:Bamacan	nci:Chondroitin_Sulfate_Proteoglycan-6	0.5
fma:Cavernous_sinus	nci:Cavernous_Sinus	0.6
fma:Submandibular_ganglion	nci:Submandibular_Ganglion	0.63
fma:Cuneate_nucleus	nci:Cuneate_Nucleus	0.59
fma:Levator_ani	nci:Levator_Ani	0.66
fma:Hepatocyte	nci:Hepatocyte	0.7
fma:Pyrimidine	nci:Pyrimidine	0.66
fma:Antihelix	nci:Antihelix	0.54
fma:Endolymph	nci:Endolymph	0.58
fma:Perineum	nci:Perineum	0.55
fma:Ascending_aorta	nci:Ascending_Aorta	0.63
fma:Foramen_magnum	nci:Foramen_Magnum	0.5
fma:Upper_limb	nci:Upper_Extremity	0.7
fma:Set_of_vallate_papillae	nci:Circumvallate_Papilla	0.54
fma:Chorda_tendinea	nci:Chordae_Tendineae	0.51
fma:Peroxisome	nci:Peroxisome	0.7
fma:Immunoglobulin_G	nci:IgG	0.63
fma:Short_insular_gyrus	nci:Gyri_Breves_Insulae	0.17
fma:Left	nci:Left	0.5
fma:Set_of_phalanges	nci:Phalanx_of_the_Hand	0.23
fma:Decidua_capsularis	nci:Decidua_Capsularis	0.56
fma:Viscus	nci:Viscera	0.3
fma:Trigeminal_nerve	nci:Trigeminal_Nerve	0.58
fma:Semispinalis_thoracis	nci:Semispinalis_Thoracis	0.59
fma:Mature_sperm_cell	nci:Spermatozoon	0.7
fma:Upper_eyelid	nci:Upper_Eyelid	0.6
fma:Inferior_rectus	nci:Inferior_Rectus_Muscle	0.6
fma:Actin_myofilament	nci:Thin_Filament	0.71
fma:Fossa	nci:Fossa	0.5
fma:Pulmonary_artery	nci:Pulmonary_Artery	0.59
fma:Intrapulmonary_bronchus	nci:Intrapulmonary_Bronchus	0.61
fma:Biceps_femoris	nci:Biceps_Femoris	0.63
fma:Thyroid_follicular_cell	nci:Thyroid_Gland_Follicular_Cell	0.72
fma:Meningeal_dura	nci:Meningeal_Layer_of_the_Dura_Mater	0.52
fma:Cytoplasm	nci:Cytoplasm	0.53
fma:Circular_muscle_layer_of_abdominal_part_of_esophagus	nci:Lower_Esophageal_Sphincter	0.54
fma:Feces	nci:Feces	0.58
fma:Set_of_viscera	nci:Viscera	0.5
fma:Extrahepatic_bile_duct	nci:Extrahepatic_Bile_Duct	0.74
fma:Right_brachiocephalic_vein	nci:Right_Innominate_Vein	0.64
fma:Lower_uterine_segment	nci:Isthmus_Uteri	0.55
fma:Tail_of_epididymis	nci:Tail_of_the_Epididymis	0.52
fma:Ectodermal_cell	nci:Ectoderm_Cell	0.6
fma:Interlobular_bile_duct	nci:Interlobular_Bile_Duct	0.73
fma:Popliteus	nci:Popliteus_Muscle	0.58
fma:Set_of_cerebral_gyri	nci:Cerebral_Gyrus	0.48
fma:Greater_vestibular_gland	nci:Bartholin_s_Gland	0.6
fma:Paraurethral_gland	nci:Paraurethral_Gland	0.63
fma:External_iliac_vein	nci:External_Iliac_Vein	0.57
fma:Chorion	nci:Chorion	0.65
fma:Fascia_lata	nci:Fascia_Lata	0.54
fma:Inguinal_lymph_node	nci:Inguinal_Lymph_Node	0.66
fma:Schwann_cell	nci:Schwann_Cell	0.63
fma:Masseteric_artery	nci:Masseteric_Artery	0.59
fma:Nuclear_pore	nci:Nuclear_Pore	0.63
fma:Set_of_eyelashes	nci:Eyelash	0.52
fma:Neural_crest	nci:Neural_Crest	0.64
fma:Spinal_ganglion	nci:Dorsal_Root_Ganglion	0.52
fma:Middle_frontal_gyrus	nci:Middle_Frontal_Gyrus	0.54
fma:Endoneurium	nci:Endoneurium	0.78
fma:Middle	nci:Middle	0.5
fma:Occipital_bone	nci:Occipital_Bone	0.64
fma:Aorta	nci:Aorta	0.55
fma:Psoas_minor	nci:Psoas_Minor	0.57
fma:Middle_rectal_artery	nci:Middle_Hemorrhoidal_Artery	0.42
fma:Brush_border	nci:Striated_Border	0.15
fma:Female_breast	nci:Female_Breast	0.61
fma:Set_of_sural_arteries	nci:External_Sural_Artery	0.49
fma:Type_I_alveolar_epithelial_cell	nci:Alveolar_Cell_Type_I	0.75
fma:Choroidal_fissure	nci:Choroidal_Fissure	0.5
fma:Dendrite	nci:Dendrite	0.54
fma:Set_of_abdominal_lymph_nodes	nci:Intra-abdominal_Lymph_Node	0.46
fma:Chromatid	nci:Chromatid	0.61
fma:Cervix_of_uterus	nci:Cervix	0.55
fma:Longus_colli	nci:Longus_Colli	0.59
fma:Lipid_droplet	nci:Lipid_Inclusion	0.31
fma:Liver	nci:Liver	0.64
fma:Peritoneum	nci:Peritoneum	0.6
fma:Inferior_nasal_concha	nci:Inferior_Turbinate	0.63
fma:Ethmoid	nci:Ethmoid_Bone	0.61
fma:Cube	nci:Cube	0.65
fma:Oxyphil_cell_of_thyroid	nci:Thyroid_Gland_Oxyphil_Cell	0.71
fma:Myosin_myofilament	nci:Thick_Filament	0.61
fma:Right_subcostal_vein	nci:Right_Subcostal_Vein	0.64
fma:Bone_of_scaphoid	nci:Scaphoid_Bone	0.53
fma:Eyebrow	nci:Eyebrow	0.5
fma:Primary_dentition	nci:Temporary_Tooth	0.43
fma:Region_of_prostatic_stroma	nci:Prostatic_Stroma	0.46
fma:Actin_filament	nci:Actin_Filament	0.69
fma:Pineal_body	nci:Pineal_Gland	0.63
fma:Outer_segment_of_rod_cell	nci:Rod_Outer_Segment	0.56
fma:Oral_cavity	nci:Buccal_Cavity	0.5
fma:Ventral_anterior_nucleus	nci:Ventroanterior_Nucleus_of_the_Thalamus	0.55
fma:Hepatic_sinusoid	nci:Hepatic_Sinusoid	0.55
fma:Abducens_nucleus	nci:Abducens_Nucleus	0.59
fma:Crypt_of_Lieberkuhn_of_small_intestine	nci:Small_Intestinal_Crypt_of_Lieberkuhn	0.61
fma:Posterior_wall_of_urinary_bladder	nci:Posterior_Wall_of_the_Bladder	0.51
fma:Gastric_foveola	nci:Gastric_Pit	0.5
fma:Interleukin_3	nci:Hematopoietic_Growth_Factor	0.11
fma:Set_of_oculomotor_nuclei	nci:Oculomotor_Nucleus	0.47
fma:Deep_brachial_artery	nci:Superior_Profunda_Artery	0.63
fma:Spinalis_thoracis	nci:Spinalis_Thoracis	0.59
fma:Optic_tract	nci:Optic_Tract	0.54
fma:Foramen_secundum	nci:Foramen_Secundum	0.63
fma:Peripheral_blood_stem_cell	nci:Peripheral_Blood_Stem_Cell	0.64
fma:Inferior_pharyngeal_constrictor	nci:Cricopharyngeus_Muscle	0.67
fma:Ependymal_cell	nci:Ependymocyte	0.7
fma:Cerebellar_cortex	nci:Cerebellar_Cortex	0.54
fma:Clear_chief_cell_of_parathyroid_cell	nci:Parathyroid_Gland_Clear_Cell	0.71
fma:Jejunum	nci:Jejunum	0.56
fma:Precentral_gyrus	nci:Precentral_Gyrus	0.54
fma:Buccal_salivary_gland	nci:Buccal_Salivary_Gland	0.69
fma:Type_B_cell_of_pancreatic_islet	nci:Beta_Cell	0.69
fma:Sweat_gland	nci:Sweat_Gland	0.62
fma:Thyrotroph	nci:Thyrotrope_Cell	0.71
fma:Cerumen	nci:Cerumen	0.58
fma:Labium_minus	nci:Labium_Minus	0.54
fma:Thymine	nci:Thymine	0.56
fma:Superior_vestibular_nucleus	nci:Superior_Vestibular_Nucleus	0.63
fma:Rugal_fold_of_stomach	nci:Gastric_Rugae	0.5
fma:Foot	nci:Foot	0.55
fma:Urinary_system	nci:Urinary_System	0.65
fma:Deep_artery_of_thigh	nci:Deep_Femoral_Artery	0.28
fma:Amphiarthrosis	nci:Amphiarthrosis	0.5
fma:Tarsal_gland	nci:Meibomian_Gland	0.57
fma:Splenic_lymph_node	nci:Splenic_Hilar_Lymph_Node	0.64
fma:Sex_chromosome	nci:Sex_Chromosome	0.69
fma:Cardiac_muscle_tissue	nci:Heart_Muscle	0.44
fma:Endothelium	nci:Endothelium	0.56
fma:Set_of_common_palmar_digital_arteries	nci:Common_Palmar_Digital_Artery	0.53
fma:Oculomotor_nerve	nci:Oculomotor_Nerve	0.63
fma:Tympanic_membrane	nci:Tympanic_Membrane	0.59
fma:Lysosome	nci:Lysosome	0.66
fma:Efferent_ductule	nci:Efferent_Ductule	0.55
fma:Auditory_cortex	nci:Auditory_Cortex	0.59
fma:Dopaminergic_neuron	nci:Dopaminergic_Cell	0.71
fma:Continuous_capillary	nci:Continuous_Capillary	0.61
fma:Greater_omentum	nci:Greater_Omentum	0.63
fma:Anterior_mediastinal_lymph_node	nci:Anterior_Mediastinal_Lymph_Node	0.75
fma:Right_colic_flexure	nci:Hepatic_Flexure	0.56
fma:Mucosa_of_lower_lip	nci:Mucosa_of_the_Lower_Lip	0.58
fma:Cartilage_of_bronchus	nci:Bronchus_Cartilage	0.5
fma:Basilar_membrane_of_cochlea	nci:Basilar_Membrane	0.48
fma:Auditory_receptor	nci:Hair_Cell	0.03
fma:Mucosa_of_small_intestine	nci:Small_Intestinal_Mucosa	0.59
fma:Membrane	nci:Membrane	0.5
fma:Aggregated_lymphoid_follicle_of_small_intestine	nci:Peyer_s_Patch	0.82
fma:Set_of_sternocostal_joints	nci:Sternocostal_Joint	0.55
fma:Nucleoplasm	nci:Nucleoplasm	0.65
fma:Chemical_synapse	nci:Chemical_Synapse	0.62
fma:Sinuatrial_node	nci:Sinoatrial_Node	0.55
fma:Canal_for_tensor_tympani	nci:Canal_for_Tensor_Tympani	0.5
fma:Transversus_thoracis	nci:Transversus_Thoracis	0.67
fma:Type_2_vestibular_sensory_cell	nci:Type_II_Hair_Cell	0.61
fma:Olecranon	nci:Olecranon	0.55
fma:Neuraxis	nci:Central_Nervous_System	0.56
fma:Anterior_temporal_artery	nci:Anterior_Temporal_Artery	0.66
fma:Muscularis_mucosae	nci:Muscularis_Mucosa	0.65
fma:Osteon	nci:Haversian_System	0.55
fma:Right_lymphatic_duct	nci:Right_Lymphatic_Duct	0.65
fma:Chondrocyte	nci:Cartilage_Cell	0.64
fma:Nasal_cavity	nci:Nasal_Cavity	0.5
fma:Myoblast	nci:Myoblast	0.64
fma:Ulnar_artery	nci:Ulnar_Artery	0.58
fma:Myeloid_stem_cell	nci:Bone_Marrow_Myeloid_Stem_Cell	0.48
fma:Cavity_of_concha_of_pinna	nci:Cavum_Conchae	0.5
fma:Stapedius	nci:Stapedius_Muscle	0.62
fma:Basophil_cell	nci:Basophilic_Cell	0.5
fma:Cremasteric_muscle	nci:Cremaster_Muscle	0.53
fma:Deep_femoral_artery	nci:Deep_Femoral_Artery	0.58
fma:Urethra	nci:Urethra	0.73
fma:Tear	nci:Tear	0.58
fma:Plexiform_layer_of_cerebral_cortex	nci:Molecular_Layer	0.53
fma:Ilium	nci:Ilium	0.54
fma:Azygos_vein	nci:Azygos_Vein	0.59
fma:Set_of_uterine_glands	nci:Uterine_Gland	0.49
fma:Tonsil	nci:Tonsil	0.77
fma:Duct_of_epididymis	nci:Duct_of_the_Epididymis	0.68
fma:D2_receptor	nci:Dopamine_Receptor-D2	0.51
fma:Labial_salivary_gland	nci:Labial_Salivary_Gland	0.69
fma:Keratinized_cell_of_epidermis	nci:Keratinocyte	0.72
fma:Dopamine_receptor	nci:Dopamine_Receptor	0.58
fma:Sphincter_pupillae	nci:Sphincter_Pupillae_Muscle	0.55
fma:Lentiform_nucleus	nci:Lentiform_Nucleus	0.5
fma:Pelvic_girdle	nci:Pelvic_Girdle	0.55
fma:Cisterna_chyli	nci:Chyle_Cistern	0.55
fma:Muscle_of_pelvic_diaphragm	nci:Pelvic_Floor_Muscle	0.63
fma:Subscapularis	nci:Subscapularis	0.55
fma:Visual_system	nci:Visual_System	0.56
fma:Pleura	nci:Pleural_Tissue	0.58
fma:Fibrous_capsule_of_thyroid_gland	nci:Thyroid_Gland_Capsule	0.49
fma:Ectocervix	nci:Ectocervix	0.55
fma:Acromion	nci:Acromion	0.54
fma:Set_of_pancreatic_islets	nci:Islet_of_Langerhans	0.5
fma:Immunoglobulin_M	nci:IgM	0.63
fma:Middle_ear	nci:Middle_Ear	0.55
fma:Thrombospondin	nci:Thrombospondin	0.5
fma:Wall_of_peroxisome	nci:Membrane_of_the_Peroxisome	0.61
fma:Adhesive_belt	nci:Zonula_Adherens	0.73
fma:Guanine	nci:Guanine	0.56
fma:Dilatator_pupillae	nci:Dilator_Pupillae_Muscle	0.54
fma:Tenascin	nci:Tenascin-C	0.48
fma:Epithelium_of_respiratory_bronchiole	nci:Respiratory_Bronchiole_Epithelium	0.74
fma:Set_of_bronchopulmonary_lymph_nodes	nci:Bronchial_Lymph_Node	0.42
fma:Dura_mater	nci:Dura_Mater	0.57
fma:Epidermal_cell	nci:Cell_of_the_Epidermis	0.64
fma:Somite	nci:Somite	0.64
fma:Lateral	nci:Lateral	0.5
fma:Fovea_centralis	nci:Fovea_Centralis	0.54
fma:Root_of_cervical_nerve	nci:Cervical_Spinal_Nerve_Root	0.52
fma:Vestibular_ganglion	nci:Vestibular_Ganglion	0.62
fma:Phrenic_nerve	nci:Phrenic_Nerve	0.57
fma:Skin_of_hand	nci:Hand_Skin	0.62
fma:Hypodermis	nci:Subcutis	0.14
fma:Arginine	nci:Arginine	0.5
fma:Laryngeal_cartilage	nci:Laryngeal_Cartilage	0.82
fma:Proximal	nci:Proximal	0.5
fma:Skin_of_eyelid	nci:Eyelid_Skin	0.63
fma:Crus_of_helical_part_of_auricular_cartilage	nci:Crus_Helicis	0.54
fma:Set_of_efferent_ductules	nci:Efferent_Ductule	0.49
fma:Cochlea	nci:Cochlea	0.55
fma:Set_of_joints_of_pelvic_girdle	nci:Joint_of_the_Pelvic_Girdle	0.46
fma:Basal_cell	nci:Basal_Cell	0.65
fma:Stearic_acid	nci:Stearic_Acid	0.5
fma:Embryonic_cell	nci:Embryonic_Cell	0.67
fma:Sex_chromatin	nci:Barr_Body	0.61
fma:Cochlear_outer_hair_cell	nci:Outer_Hair_Cell_of_the_Organ_of_the_Corti	0.75
fma:Parahippocampal_gyrus	nci:Parahippocampal_Gyrus	0.54
fma:Hindbrain	nci:Hind-Brain	0.53
fma:Proximal_epiphysis_of_tibia	nci:Head_of_the_Tibia	0.5
fma:Interleukin_2	nci:Interleukin-2	0.69
fma:Zona_pellucida	nci:Zona_Pellucida	0.56
fma:Carpometacarpal_joint	nci:Carpometacarpal_Joint	0.57
fma:Interstitial_cell_of_Leydig	nci:Leydig_Cell	0.6
fma:Talocalcaneal_joint	nci:Subtalar_Joint	0.62
fma:Skin_of_leg	nci:Leg_Skin	0.62
fma:Cusp	nci:Cusp	0.5
fma:Mylohyoid	nci:Mylohyoid	0.63
fma:Callosomarginal_artery	nci:Callosomarginal_Artery	0.62
fma:Claustrum	nci:Claustrum	0.54
fma:Superficial_lymphatic_vessel	nci:Superficial_Lymphatic_Vessel	0.57
fma:Postcentral_sulcus	nci:Postcentral_Sulcus	0.5
fma:Splenic_cord	nci:Splenic_Cord	0.55
fma:Taste_bud_cell	nci:Taste_Bud_Cell	0.75
fma:Adventitial_cell	nci:Pericyte	0.5
fma:Goblet_cell	nci:Goblet_Cell	0.59
fma:Clavicle	nci:Clavicle	0.62
fma:Subclavian_artery	nci:Subclavian_Artery	0.66
fma:Bone_of_capitate	nci:Capitate_Bone	0.53
fma:Blood_cell	nci:Peripheral_Blood_Cell	0.5
fma:Interleukin_3	nci:Interleukin-3	0.68
fma:Multipolar_neuron	nci:Multipolar_Neuron	0.63
fma:Hippocampal_sulcus	nci:Hippocampal_Fissure	0.5
fma:Frontal_lobe	nci:Frontal_Lobe	0.54
fma:Left_mammary_gland	nci:Left_Breast	0.13
fma:Articular_disc	nci:Meniscus	0.5
fma:Flatus	nci:Flatus	0.5
fma:Set_of_dorsal_interossei_of_foot	nci:Dorsal_Foot_Interosseous_Muscle	0.44
fma:Fenestrated_capillary	nci:Fenestrated_Capillary	0.61
fma:Superior_colliculus	nci:Anterior_Quadrigeminal_Body	0.54
fma:Alpha_cell	nci:Alpha_Cell	0.5
fma:Lacrimal_gland	nci:Lacrimal_Gland	0.6
fma:Basaloid_cell	nci:Basaloid_Cell	0.5
fma:Basal_layer_of_endometrium	nci:Basal_Layer_of_the_Endometrium	0.53
fma:Granular_layer_of_epidermis	nci:Stratum_Granulosum	0.48
fma:Molar_tooth	nci:Molar_Tooth	0.67
fma:Corpus_striatum	nci:Corpus_Striatum	0.5
fma:Fibularis_longus	nci:Peroneus_Longus	0.64
fma:Hypoglossal_nerve_nucleus	nci:Nucleus_of_the_Hypoglossal_Nerve	0.48
fma:Pseudostratified_columnar_epithelium	nci:Pseudostratified_Columnar_Epithelium	0.84
fma:Peritoneal_cavity	nci:Peritoneal_Cavity	0.56
fma:P_selectin	nci:P-Selectin	0.64
fma:Superficial_palmar_arterial_arch	nci:Superficial_Palmar_Arch	0.57
fma:Epineurium	nci:Epineurium	0.71
fma:Nervous_system	nci:Nervous_System	0.68
fma:Venule	nci:Venule	0.57
fma:Adipocyte	nci:Adipocyte	0.62
fma:Muscle_layer_of_large_intestine	nci:Large_Intestinal_Muscular_Coat	0.48
fma:Branch_of_brachial_artery	nci:Brachial_Artery_Branch	0.55
fma:Epidermis	nci:Epidermis	0.59
fma:Vertebral_arch	nci:Arch_of_the_Vertebra	0.49
fma:Inferior_colliculus	nci:Posterior_Quadrigeminal_Body	0.54
fma:Major_histocompatibility_complex_gene	nci:Major_Histocompatibility_Complex_Gene	0.55
fma:Internal_iliac_vein	nci:Internal_Iliac_Vein	0.57
fma:Set_of_parasternal_lymph_nodes	nci:Internal_Mammary_Lymph_Node	0.33
fma:Descending_limb_of_loop_of_Henle	nci:Descending_Limb_of_the_Henle_s_Loop	0.6
fma:Apical	nci:Apical	0.5
fma:Interleukin_1	nci:Interleukin-1	0.65
fma:Granular_component_of_nucleolus	nci:Nucleolonema	0.62
fma:Skin_of_elbow	nci:Elbow_Skin	0.62
fma:Left_lower_first_secondary_molar_tooth	nci:Tooth_19	0.51
fma:Central_sulcus	nci:Sulcus_Centralis	0.5
fma:Lobule_of_thymus	nci:Thymic_Lobule	0.48
fma:Navicular_bone_of_foot	nci:Navicular_Bone	0.56
fma:Orbiculus_ciliaris	nci:Orbiculus_Ciliaris	0.55
fma:Flexor_carpi_radialis	nci:Flexor_Carpi_Radialis	0.59
fma:Set_of_nasal_cartilages	nci:Nasal_Cartilage	0.54
fma:Nasal_septum	nci:Nasal_Septum	0.55
fma:Septum_pellucidum	nci:Septum_Pellucidum	0.55
fma:Root_of_sacral_nerve	nci:Sacral_Spinal_Nerve_Root	0.57
fma:Forearm	nci:Forearm	0.55
fma:Portion_of_blood	nci:Blood	0.52
fma:Masseter	nci:Masseter_Muscle	0.53
fma:Plantar_part_of_foot	nci:Plantar_Region	0.55
fma:Embryonic_stem_cell	nci:Embryonic_Stem_Cell	0.65
fma:Anterior_chamber_of_eyeball	nci:Anterior_Chamber_of_the_Eye	0.59
fma:Cerebellum	nci:Cerebellum	0.55
fma:Sartorius	nci:Sartorius_Muscle	0.63
fma:Axon	nci:Axon	0.58
fma:Lower_lobe_of_right_lung	nci:Lower_Lobe_of_the_Right_Lung	0.62
fma:Set_of_infraclavicular_lymph_nodes	nci:Infraclavicular_Lymph_Node	0.59
fma:Granular_leukocyte	nci:Granulocyte	0.65
fma:Hair	nci:Hair	0.54
fma:Blastomere	nci:Blastomere	0.6
fma:Sternocleidomastoid	nci:Sternocleidomastoid_Muscle	0.62
fma:Biliary_system	nci:Biliary_Tract	0.56
fma:Fornix_of_vagina	nci:Vaginal_Fornix	0.5
fma:Seminal_fluid	nci:Semen	0.17
fma:Body_of_corpus_callosum	nci:Body_of_the_Corpus_Callosum	0.52
fma:Fontanelle	nci:Fontanelle	0.55
fma:Sphenoid_bone	nci:Sphenoid_Bone	0.64
fma:Collagen_fiber	nci:Collagen_Fiber	0.59
fma:Olfactory_epithelium	nci:Olfactory_Epithelium	0.7
fma:Peripheral_blood_cell	nci:Peripheral_Blood_Cell	0.5
fma:Cell_coat	nci:Glycocalyx	0.64
fma:Small_intestine	nci:Small_Intestine	0.56
fma:Soleus	nci:Soleus	0.64
fma:Myofilament	nci:Actin_Filament	0.54
fma:Bile_canaliculus	nci:Bile_Canaliculus	0.5
fma:Middle_temporal_gyrus	nci:Middle_Temporal_Gyrus	0.54
fma:Triangular	nci:Triangle	0.5
fma:Synovial_joint	nci:Diarthrosis	0.6
fma:Dental_pulp_cell	nci:Tooth_Cell	0.58
fma:Nerve_plexus	nci:Nerve_Plexus	0.67
fma:Pulmonary_arterial_trunk	nci:Pulmonary_Artery	0.49
fma:Pectoral_muscle	nci:Pectoralis_Muscle	0.73
fma:Inferior_temporal_sulcus	nci:Inferior_Temporal_Sulcus	0.5
fma:Masticatory_muscle	nci:Muscle_of_the_Mastication	0.55
fma:Posterior_temporal_artery	nci:Posterior_Temporal_Artery	0.66
fma:Plakoglobin	nci:Junction_Plakoglobin	0.63
fma:Crico_arytenoid_joint	nci:Cricoarytenoid_Joint	0.62
fma:Coracobrachialis	nci:Coracobrachialis	0.64
fma:Histone_H2B	nci:Histone-H2B	0.63
fma:Secretion_of_seminal_vesicle	nci:Seminal_Vesicle_Secretion	0.57
fma:Type_A_cell_of_pancreatic_islet	nci:Alpha_Cell	0.6
fma:External_carotid_artery	nci:External_Carotid_Artery	0.57
fma:Inferior_frontal_gyrus	nci:Inferior_Frontal_Convolution	0.54
fma:Olfactory_trigone	nci:Trigonum_Olfactorium	0.55
fma:Set_of_chordae_tendineae_of_heart	nci:Chordae_Tendineae	0.45
fma:Ischium	nci:Hip	0.05
fma:Sternothyroid	nci:Sternothyroid	0.63
fma:Distal_convoluted_tubule	nci:Distal_Convoluted_Tubule	0.59
fma:Neurilemma	nci:Sheath_of_Schwann	0.65
fma:Vocal_fold	nci:Vocal_Cord	0.55
fma:Dorsum_of_tongue	nci:Dorsum_of_the_Tongue	0.52
fma:Tract_of_spinal_cord	nci:Spinal_Cord_Tract	0.51
fma:Simple_columnar_epithelium	nci:Simple_Columnar_Epithelium	0.76
fma:Renal_pyramid	nci:Renal_Pyramid	0.54
fma:Buccinator	nci:Buccinator	0.67
fma:Laryngopharynx	nci:Laryngopharynx	0.5
fma:Muscular_layer_of_bladder	nci:Bladder_Muscular_Coat	0.53
fma:Carina_of_trachea	nci:Carina	0.56
fma:Antitragus	nci:Antitragus	0.54
fma:Anterior_surface_of_lens	nci:Anterior_Surface_of_the_Lens	0.54
fma:Granulosa_cell_of_ovary	nci:Ovarian_Granulosa_Cell	0.53
fma:Cadherin	nci:Cadherin	0.67
fma:Eyelash	nci:Eyelash	0.58
fma:Iris	nci:Iris	0.55
fma:Aortic_valve	nci:Aortic_Valve	0.67
fma:Histone_H2A	nci:Histone-H2A	0.62
fma:Obturator_vein	nci:Obturator_Vein	0.58
fma:Prostatic_capsule	nci:Capsule_of_the_Prostate	0.52
fma:Fibroblast	nci:Fibroblast	0.6
fma:Deferent_duct	nci:Vas_Deferens	0.66
fma:Hypodermis	nci:Superficial_Fascia	0.05
fma:Skeleton_of_upper_limb	nci:Bone_of_the_Upper_Extremity	0.34
fma:Skin_of_trunk	nci:Skin_of_the_Trunk	0.64
fma:Prepuce_of_clitoris	nci:Female_Prepuce	0.54
fma:Posterior_crico_arytenoid_ligament	nci:Posterior_Cricoarytenoid_Ligament	0.63
fma:Nail_of_toe	nci:Toe_Nail	0.56
fma:Immunoglobulin_E	nci:IgE	0.63
fma:Vestibular_nucleus	nci:Vestibular_Nucleus	0.85
fma:Capsule_of_adrenal_gland	nci:Adrenal_Gland_Capsule	0.55
fma:Frontal_sinus	nci:Frontal_Sinus	0.5
fma:Inferior_temporal_gyrus	nci:Inferior_Temporal_Gyrus	0.54
fma:Histone_H4	nci:Histone-H4	0.62
fma:Longitudinal_duct_of_epoophoron	nci:Duct_of_the_Gartner	0.64
fma:Superior_frontal_gyrus	nci:Superior_Frontal_Convolution	0.54
fma:Compact_bone	nci:Cortical_Bone	0.51
fma:Set_of_phalanges_of_hand	nci:Phalanx_of_the_Hand	0.5
fma:Posterior_lobe_of_prostate	nci:Posterior_Lobe_of_the_Prostate	0.57
fma:Point	nci:Point	0.5
fma:Quadrate_lobe_of_liver	nci:Lobus_Quadratus	0.55
fma:Abdominal_lymph_node	nci:Intra-abdominal_Lymph_Node	0.5
fma:Sensory_ganglion	nci:Sensory_Ganglion	0.52
fma:Cerebral_crus	nci:Cerebral_Peduncle	0.42
fma:Interleukin_8	nci:Interleukin-8	0.67
fma:E_selectin	nci:E-Selectin	0.64
fma:Piriform_fossa	nci:Pyriform_Sinus	0.5
fma:Mesodermal_cell	nci:Mesoderm_Cell	0.66
fma:Lymphocyte	nci:Lymphocyte	0.63
fma:Intraparietal_sulcus	nci:Intraparietal_Sulcus	0.5
fma:Cardiac_valve	nci:Cardiac_Valve	0.71
fma:Bronchial_associated_lymphoid_tissue	nci:Bronchus-Associated_Lymphoid_Tissue	0.75
fma:Interleukin_9	nci:Interleukin-9	0.69
fma:Stomatognathic_system	nci:Stomatognathic_System	0.57
fma:Hyoglossus	nci:Hyoglossus_Muscle	0.66
fma:Cricothyroid_joint	nci:Cricothyroid_Joint	0.62
fma:Secretory_granule	nci:Secretory_Granule	0.6
fma:Lacrimal_sac	nci:Lacrimal_Sac	0.55
fma:Set_of_plantar_metatarsal_arteries	nci:Plantar_Metatarsal_Artery	0.53
fma:Set_of_splenic_lymph_nodes	nci:Splenic_Hilar_Lymph_Node	0.5
fma:Oxyphil_cell_of_parathyroid_gland	nci:Parathyroid_Gland_Oxyphil_Cell	0.7
fma:Pyramidal_lobe_of_thyroid_gland	nci:Pyramidal_Lobe	0.54
fma:Set_of_bronchioles	nci:Bronchiole	0.5
fma:Trunk	nci:Trunk	0.56
fma:Thyroid_follicle	nci:Thyroid_Gland_Follicle	0.51
fma:Left_gastric_vein	nci:Coronary_Vein	0.09
fma:Parafollicular_cell_of_thyroid_gland	nci:Parafollicular_Cell	0.72
fma:Interleukin_7	nci:Interleukin-7	0.69
fma:Angular_artery	nci:Angular_Artery	0.61
fma:Set_of_interphalangeal_joints_of_foot	nci:Interphalangeal_Joint_of_the_Foot	0.49
fma:Set_of_transverse_planes	nci:Transverse_Plane	0.49
fma:Primary_oocyte	nci:Primary_Oocyte	0.61
fma:Metacarpal_bone	nci:Metacarpal_Bone	0.74
fma:Superior_cerebellar_artery	nci:Superior_Cerebellar_Artery	0.62
fma:Laryngopharynx	nci:Hypopharynx	0.56
fma:Mucosa_of_larynx	nci:Laryngeal_Mucosa	0.6
fma:Epithelium_of_trachea	nci:Tracheal_Epithelium	0.77
fma:Posterior_wall_of_laryngopharynx	nci:Posterior_Wall_of_the_Hypopharynx	0.56
fma:Endothelium_of_capillary	nci:Capillary_Endothelium	0.63
fma:Deep_lymphatic_vessel	nci:Deep_Lymphatic_Vessel	0.54
fma:Conjunctival_gland	nci:Gland_of_Krause	0.56
fma:Lobe_of_lung	nci:Lung_Lobe	0.67
fma:Greater_curvature_of_stomach	nci:Greater_Curvature	0.54
fma:Nasal_bone	nci:Nasal_Bone	0.63
fma:Myelin_sheath	nci:Myelin_Sheath	0.55
fma:Flat_bone	nci:Flat_Bone	0.73
fma:Immunoglobulin_D	nci:IgD	0.63
fma:Pulmonary_valve	nci:Pulmonary_Valve	0.67
fma:Endometrial_stroma	nci:Endometrial_Stroma	0.56
fma:Myristic_acid	nci:Myristic_Acid	0.5
fma:Precentral_sulcus	nci:Precentral_Sulcus	0.5
fma:Set_of_pharyngeal_muscles	nci:Pharyngeal_Muscle	0.55
fma:Dense_irregular_connective_tissue	nci:Irregular_Dense_Connective_Tissue	0.7
fma:Minus_end_of_actin_filament	nci:Minus_End_of_the_Actin_Filament	0.62
fma:Gut_associated_lymphoid_tissue	nci:Gut_Associated_Lymphoid_Tissue	0.67
fma:Cistern_of_lamina_terminalis	nci:Lamina_Terminalis_Cistern	0.56
fma:Deep_middle_cerebral_vein	nci:Deep_Middle_Cerebral_Vein	0.63
fma:Set_of_lactiferous_glands	nci:Mammary_Gland	0.54
fma:Left_testicular_artery	nci:Left_Spermatic_Artery	0.63
fma:Lower_gastrointestinal_tract	nci:Lower_Gastrointestinal_Tract	0.62
fma:Palmitic_acid	nci:Palmitic_Acid	0.5
fma:Urothelium	nci:Urothelium	0.68
fma:Endocrine_system	nci:Endocrine_System	0.5
fma:Jaw	nci:Jaw	0.66
fma:Simple_squamous_epithelium	nci:Simple_Squamous_Epithelium	0.7
fma:Posterior_surface_of_lens	nci:Facies_Posterior_Lentis	0.5
fma:Posterior_spinal_artery	nci:Posterior_Spinal_Artery	0.64
fma:Cardiac_septum	nci:Heart_Septum	0.61
fma:Dentition	nci:Tooth	0.5
fma:Mitochondrial_crista	nci:Mitochondrial_Crista	0.62
fma:Right_ventricle	nci:Right_Ventricle	0.61
fma:Histone_H3	nci:Histone-H3	0.63
fma:Face	nci:Face	0.56
fma:Reticulocyte	nci:Polychromatophilic_Erythrocyte	0.65
fma:Stromal_cell	nci:Stromal_Cell	0.5
fma:Eyeball	nci:Eye	0.62
fma:Euchromatin	nci:Euchromatin	0.66
fma:Olfactory_receptor_cell	nci:Olfactory_Cell	0.54
fma:Central_insular_sulcus	nci:Sulcus_Centralis_Insulae	0.5
fma:Chromatin	nci:Chromatin	0.77
fma:Nissl_body	nci:Nissl_Body	0.55
fma:Internal_cerebral_vein	nci:Internal_Cerebral_Vein	0.63
fma:Superior_pancreaticoduodenal_artery	nci:Superior_Pancreatico-Duodenal_Artery	0.57
fma:Penis	nci:Penis	0.55
fma:Throat	nci:Pharynx	0.06
fma:External_ear	nci:Auricle	0.28
fma:Interleukin_12A	nci:Interleukin-12A	0.56
fma:Interleukin_5	nci:Interleukin-5	0.68
fma:Longissimus_cervicis	nci:Longissimus_Cervicis	0.59
fma:Thyrotropin	nci:Thyroid_Stimulating_Hormone	0.5
fma:Transversus_abdominis	nci:Transversus_Abdominis	0.66
fma:Set_of_common_iliac_lymph_nodes	nci:Iliac_Lymph_Node	0.5
fma:Lacrimal_nerve	nci:Lacrimal_Nerve	0.57
fma:Set_of_filiform_papillae	nci:Filiform_Papilla	0.55
fma:Interleukin_12B	nci:Interleukin-12B	0.56
fma:Interleukin_6	nci:Interleukin-6	0.66
fma:Choroid_plexus_of_lateral_ventricle	nci:Choroid_Plexus_of_the_Lateral_Ventricle	0.53
fma:Anterior_olfactory_nucleus	nci:Anterior_Olfactory_Nucleus	0.59
fma:External_nose	nci:External_Nose	0.56
fma:Stroma	nci:Stroma_Connective_Tissue	0.51
fma:Renal_papilla	nci:Renal_Papilla	0.55
fma:Hymen_of_vagina	nci:Hymen	0.55
fma:Glycosaminoglycan	nci:Glycosaminoglycan	0.64
fma:Pubis	nci:Pubic_Bone	0.35
fma:Canine_tooth	nci:Canine_Tooth	0.72
fma:Olfactory_tract	nci:Olfactory_Tract	0.54
fma:Unipolar_neuron	nci:Unipolar_Neuron	0.71
fma:Interleukin_17	nci:Interleukin-17	0.69
fma:Occlusal_surface_of_tooth	nci:Occlusal_Surface	0.51
fma:Capsule_of_thymus	nci:Thymic_Capsule	0.49
fma:Outside	nci:External	0.5
fma:Alimentary_system	nci:Digestive_System	0.5
fma:Papilla_of_tongue	nci:Papilla_of_the_Tongue	0.68
fma:Colon	nci:Colon	0.56
fma:Interphalangeal_joint_of_finger	nci:Interphalangeal_Joint_of_the_Hand	0.53
fma:Horizontal	nci:Horizontal	0.5
fma:Syndecan	nci:Syndecans	0.48
fma:Basicranium	nci:Base_of_the_Skull	0.56
fma:Digastric	nci:Digastric_Muscle	0.54
fma:Bone_of_cuboid_bone	nci:Cuboid_Bone	0.52
fma:Rostral	nci:Cephalad	0.0
fma:Collateral_sulcus	nci:Collateral_Fissure	0.5
fma:Gingival_epithelium	nci:Gingival_Epithelium	0.77
fma:Foramen_ovale_of_heart	nci:Oval_Foramen	0.49
fma:Semispinalis_cervicis	nci:Semispinalis_Cervicis	0.59
fma:Roof_of_fourth_ventricle	nci:Roof_of_the_Fourth_Ventricle	0.53
fma:Horny_layer_of_epidermis	nci:Stratum_Corneum	0.47
fma:Epithelium_of_oropharynx	nci:Oropharynx_Epithelium	0.67
fma:Set_of_spinal_nerves	nci:Spinal_Nerve	0.59
fma:Accessory_pancreatic_duct	nci:Ductus_Santorini	0.76
fma:Right_renal_artery	nci:Right_Renal_Artery	0.62
fma:Obturator_muscle	nci:Obturator_Muscle	0.63
fma:Sweat	nci:Sweat	0.56
fma:Inferior_surface_of_liver	nci:Visceral_Surface_of_the_Liver	0.55
fma:Ileocecal_valve	nci:Ileocecal_Valve	0.56
fma:Peritoneal_fluid	nci:Peritoneal_Effusion	0.29
fma:Set_of_endocrine_glands	nci:Endocrine_Gland	0.52
fma:Epimysium	nci:Epimysium	0.56
fma:Immunoglobulin_A	nci:IgA	0.63
fma:Y_chromosome	nci:Chromosome_Y	0.65
fma:Ductus_venosus	nci:Ductus_Venosus	0.63
fma:Fossa_of_antihelix	nci:Fossa_of_the_Antihelix	0.5
fma:Abductor_pollicis_longus	nci:Abductor_Pollicis_Longus	0.59
fma:Abdominal_aorta	nci:Abdominal_Aorta	0.59
fma:Interleukin_18	nci:Interleukin-18	0.69
fma:Sacrum	nci:Sacral_Bone	0.64
fma:Celiac_artery	nci:Coeliac_Artery	0.59
fma:Obturator_artery	nci:Obturator_Artery	0.58
fma:Lymphokine_activated_natural_killer_cell	nci:Lymphokine-Activated_Natural_Killer_Cell	0.62
fma:Common_iliac_artery	nci:Common_Iliac_Artery	0.64
fma:Hypogastrium	nci:Hypogastric_Region	0.56
fma:Pulmonary_lobule	nci:Pulmonary_Lobule	0.55
fma:Intercostal_nerve	nci:Intercostal_Nerve	0.53
fma:Vasa_vasorum	nci:Vasa_Vasorum	0.55
fma:Posterior_segment_of_eyeball	nci:Posterior_Eye_Segment	0.55
fma:Semispinalis_capitis	nci:Semispinalis_Capitis	0.59
fma:Yolk_sac	nci:Yolk_Sac	0.65
fma:Set_of_lymph_nodes_of_head_and_neck	nci:Head_and_Neck_Lymph_Node	0.54
fma:Superficial_middle_cerebral_vein	nci:Superficial_Middle_Cerebral_Vein	0.58
fma:Interleukin_4	nci:Interleukin-4	0.69
fma:Adrenal_gland	nci:Adrenal_Gland	0.69
fma:Special_sense_organ	nci:Organ_of_the_Special_Sense	0.5
fma:Nephron	nci:Nephron	0.55
fma:Ganglion_cell_of_retina	nci:Retinal_Ganglion_Cell	0.79
fma:Bone_marrow_stem_cell	nci:Bone_Marrow_Stem_Cell	0.59
fma:Cystic_vein	nci:Cystic_Vein	0.59
fma:Right_common_iliac_artery	nci:Right_Common_Iliac_Artery	0.63
fma:Interatrial_septum	nci:Interatrial_Septum	0.61
fma:Right_main_bronchus	nci:Right_Main_Bronchus	0.65
fma:Focal_adhesion_plaque	nci:Focal_Adhesion	0.67
fma:Triangular_ligament	nci:Triangular_Ligament	0.54
fma:Broad_ligament_of_uterus	nci:Lateral_Ligament	0.31
fma:Interstitial_cell_of_ovary	nci:Theca_Cell	0.55
fma:Macula_lutea	nci:Macula	0.55
fma:Muscle_cell	nci:Muscle_Cell	0.71
fma:Secondary_nodular_lymphoid_tissue	nci:Germinal_Center	0.73
fma:Protoplasmic_astrocyte	nci:Protoplasmic_Astrocyte	0.77
fma:Mandibular_nerve	nci:Inferior_Maxillary_Nerve	0.57
fma:Branch_of_left_coronary_artery	nci:Left_Coronary_Artery_Branch	0.62
fma:Microtubule_associated_protein	nci:Microtubule_Associated_Protein	0.56
fma:Bronchiolar_non_ciliated_cell	nci:Clara_Cell	0.7
fma:Deep	nci:Deep	0.5
fma:Submucosa_of_small_intestine	nci:Small_Intestinal_Submucosa	0.61
fma:Muscle_of_neck	nci:Neck_Muscle	0.6
fma:Fimbria_of_hippocampus	nci:Fimbria	0.4
fma:Labyrinthine_artery	nci:Internal_Auditory_Artery	0.62
fma:Glucitol	nci:Sorbitol	0.11
fma:Interstitial_cell	nci:Interstitial_Cell	0.5
fma:Costal_cartilage	nci:Costal_Cartilage	0.52
fma:Amnion	nci:Amnion	0.65
fma:Inferior_rectal_artery	nci:Inferior_Rectal_Artery	0.59
fma:Intervertebral_disk	nci:Intervertebral_Disc	0.52
fma:Granulosa_cell_of_ovary	nci:Granulosa_Cell	0.59
fma:Deep	nci:Depth	0.0
fma:Proximal_epiphysis_of_fibula	nci:Head_of_the_Fibula	0.51
fma:Endocrine_cell	nci:Endocrine_Cell_and_Neuroendocrine_Cell	0.5
fma:Tectorial_membrane_of_cochlea	nci:Tectorial_Membrane	0.55
fma:Organ_system	nci:Organ_System	0.85
fma:Orbital_sulcus	nci:Orbital_Sulcus	0.5
fma:Anterior_spinal_artery	nci:Anterior_Spinal_Artery	0.57
fma:Cartilage_of_rib	nci:Costal_Cartilage	0.42
fma:Corticotropin_releasing_factor	nci:Corticotropin_Releasing_Hormone	0.5
fma:Hilum_of_lymph_node	nci:Lymph_Node_Hilum	0.56
fma:Triquetral	nci:Triangular_Bone	0.61
fma:Neural_cell_adhesion_molecule	nci:Neural_Cell_Adhesion_Molecule	0.6
fma:Interleukin_15	nci:Interleukin-15	0.69
fma:T_cytotoxic_cell	nci:Cytotoxic_T-Lymphocyte	0.62
fma:Superior_cistern	nci:Ambient_Cistern	0.56
fma:Myelocyte	nci:Myelocyte	0.66
fma:Outer_membrane_of_mitochondrion	nci:Outer_Mitochondrial_Membrane	0.67
fma:Glucagon	nci:Therapeutic_Glucagon	0.5
fma:Descending_colon	nci:Left_Colon	0.1
fma:Facial_nerve	nci:Facial_Nerve	0.58
fma:Roof_of_nasopharynx	nci:Superior_Wall_of_the_Nasopharynx	0.56
fma:Medial_meniscus	nci:Meniscus_Medialis	0.58
fma:Mons_pubis	nci:Mons_Pubis	0.55
fma:External_capsule	nci:External_Capsule	0.54
fma:External_intercostal_muscle	nci:External_Intercostal_Muscle	0.72
fma:Vocalis	nci:Vocalis_Muscle	0.64
fma:Internal_granular_layer_of_cerebral_cortex	nci:Internal_Granular_Layer	0.53
fma:Laminin	nci:Laminin	0.5
fma:Iliocostalis_thoracis	nci:Iliocostal_Muscle	0.59
fma:Capitate	nci:Capitate_Bone	0.65
fma:Venous_sinus_of_red_pulp_of_spleen	nci:Splenic_Sinus	0.54
fma:Pronator_teres	nci:Pronator_Teres	0.59
fma:Inner_membrane_of_mitochondrion	nci:Inner_Mitochondrial_Membrane	0.67
fma:Tibial_nerve	nci:Tibial_Nerve	0.61
fma:Set_of_minor_salivary_glands	nci:Minor_Salivary_Gland	0.54
fma:Epithelium_of_choroid_plexus_of_fourth_ventricle	nci:Choroid_Plexus_Epithelium_of_the_Fourth_Ventricle	0.6
fma:Epiglottic_cartilage	nci:Epiglottic_Cartilage	0.65
fma:Symphysis	nci:Amphiarthrosis	0.54
fma:Thoracic_duct	nci:Thoracic_Duct	0.68
fma:Internal_thoracic_vein	nci:Internal_Mammary_Vein	0.38
fma:Sebaceous_gland	nci:Sebaceous_Gland	0.73
fma:Distal_medial_striate_artery	nci:Recurrent_Artery_of_Heubner	0.57
fma:Ampullary_crest_of_semicircular_duct	nci:Ampullary_Crest	0.55
fma:Nucleosome	nci:Nucleosome	0.61
fma:External_supporting_cell_of_vestibular_epithelium	nci:Clear_Cell	0.3
fma:Macula_lutea	nci:Macula_Lutea	0.55
fma:Lesser_curvature_of_stomach	nci:Lesser_Curvature	0.54
fma:Transport_vesicle	nci:Transport_Vesicle	0.72
fma:Muscle_of_abdomen	nci:Abdominal_Muscle	0.79
fma:Hypothalamus	nci:Hypothalamus	0.55
fma:Intestine	nci:Intestine	0.56
fma:Posterior_wall_of_pharynx	nci:Posterior_Wall_of_the_Pharynx	0.54
fma:Perimysium	nci:Perimysium	0.56
fma:Rostrum_of_corpus_callosum	nci:Rostrum_of_the_Corpus_Callosum	0.53
fma:Stratified_columnar_epithelium	nci:Stratified_Columnar_Epithelium	0.68
fma:Lingula_of_left_lung	nci:Lingula	0.53
fma:Connective_tissue_cell	nci:Connective_and_Soft_Tissue_Cell	0.68
fma:Blastocyst	nci:Blastocyst	0.63
fma:Purine	nci:Purine	0.6
fma:Fetus	nci:Fetus	0.57
fma:Tarsal_plate_of_eyelid	nci:Tarsal_Plate	0.54
fma:Ventral	nci:Ventral	0.5
fma:Interleukin_13	nci:Interleukin-13	0.69
fma:Extraglomerular_mesangial_cell	nci:Extraglomerular_Mesangial_Cell	0.6
fma:Scapula	nci:Scapula	0.62
fma:Luminal	nci:Luminal	0.5
fma:Bulbar_conjunctiva	nci:Bulbar_Conjunctiva	0.57
fma:Pronephros	nci:Pronephros	0.64
fma:Chondrocyte	nci:Chondrocyte	0.65
fma:Esophagogastric_junction	nci:Gastroesophageal_Junction	0.56
fma:Carpal_bone	nci:Carpal_Bone	0.87
fma:Columnar_cell_of_endocervix	nci:Endocervical_Columnar_Cell	0.73
fma:Left_hypochondrium	nci:Left_Hypochondriac_Region	0.61
fma:Right_subclavian_artery	nci:Right_Subclavian_Artery	0.63
fma:Thyroid_gland	nci:Thyroid_Gland	0.62
fma:Transitional_epithelium_of_renal_pelvis	nci:Renal_Pelvis_Urothelium	0.73
fma:Spinal_cord	nci:Spinal_Cord	0.55
fma:P_cadherin	nci:P-Cadherin	0.64
fma:Basement_membrane	nci:Basement_Membrane	0.52
fma:Cementocyte	nci:Cementocyte	0.61
fma:Type_II_alveolar_epithelial_cell	nci:Alveolar_Cell_Type_II	0.75
fma:Secretin	nci:Secretin	0.5
fma:Wall_of_rough_endoplasmic_reticulum	nci:Membrane_of_the_Rough_Endoplasmic_Reticulum	0.61
fma:Muscle_of_larynx	nci:Laryngeal_Muscle	0.65
fma:Mitral_valve	nci:Mitral_Valve	0.66
fma:Alveolus	nci:Alveolus	0.55
fma:Periodontium	nci:Periodontium	0.51
fma:Metatarsal_bone	nci:Metatarsal_Bone	0.74
fma:Tendinous_cuff	nci:Rotator_Cuff	0.55
fma:Collicular_artery	nci:Quadrigeminal_Artery	0.66
fma:Sperm_cell	nci:Spermatozoon	0.53
fma:Pituitary_gland	nci:Pituitary_Gland	0.62
fma:Bile_duct	nci:Bile_Duct	0.72
fma:Greater_trochanter	nci:Great_Trochanter	0.52
fma:Polychromatophilic_erythroblast	nci:Polychromatophilic_Erythroblast	0.75
fma:Exocrine_system	nci:Exocrine_System	0.5
fma:Atrioventricular_node	nci:Atrioventricular_Node	0.55
fma:Paraurethral_gland	nci:Skene_s_Gland	0.71
fma:Muscle_layer_of_esophagus	nci:Esophageal_Muscular_Coat	0.44
fma:Ependymal_cell	nci:Ependymal_Cell	0.5
fma:Temporal_artery	nci:Temporal_Artery	0.56
fma:Ventral_root	nci:Ventral_Nerve_Root	0.44
fma:Salpingopharyngeus	nci:Salpingopharyngeus	0.66
fma:Cerebral_white_matter	nci:Cerebral_White_Matter	0.59
fma:Femoral_artery	nci:Femoral_Artery	0.58
fma:Anterior_surface_of_liver	nci:Anterior_Surface_of_the_Liver	0.54
fma:Perineal_artery	nci:Perineal_Artery	0.59
fma:Common_interosseous_artery	nci:Interosseous_Artery	0.56
fma:Utricle_of_membranous_labyrinth	nci:Utricle	0.55
fma:Set_of_nasal_muscles	nci:Nasal_Muscle	0.54
fma:Cerebellar_vein	nci:Cerebellar_Vein	0.55
fma:Unilaminar_epithelium	nci:Simple_Epithelium	0.81
fma:Descending_colon	nci:Descending_Colon	0.55
fma:Globus_pallidus	nci:Globus_Pallidus	0.54
fma:Fibrous_astrocyte	nci:Fibrous_Astrocyte	0.77
fma:Lunate	nci:Lunate_Bone	0.61
fma:Thyrohyoid	nci:Thyrohyoid	0.62
fma:Tail_of_pancreas	nci:Tail_of_the_Pancreas	0.56
fma:Ductus_arteriosus	nci:Ductus_Arteriosus	0.55
fma:Subclavian_vein	nci:Subclavian_Vein	0.58
fma:Brachial_nerve_plexus	nci:Brachial_Plexus	0.67
fma:Root_of_tongue	nci:Base_of_the_Tongue	0.32
fma:Pancreatic_duct	nci:Pancreatic_Duct	0.74
fma:Set_of_ligamenta_flava	nci:Ligamentum_Flavum	0.49
fma:Posterior_communicating_artery	nci:Posterior_Communicating_Artery	0.61
fma:Right_suprarenal_vein	nci:Right_Suprarenal_Vein	0.64
fma:Secondary_oocyte	nci:Secondary_Oocyte	0.73
fma:Portion_of_neural_tissue	nci:Nervous_Tissue	0.54
fma:Lamellar_bone	nci:Mature_Bone	0.77
fma:Sulcus_limitans	nci:Sulcus_Limitans	0.5
fma:Epicondyle	nci:Epicondyle	0.53
fma:Urethral_gland	nci:Urethral_Gland	0.61
fma:Spermatocyte	nci:Spermatocyte	0.7
fma:Gluteus_medius	nci:Gluteus_Medius	0.59
fma:Interleukin_10	nci:Interleukin-10	0.69
fma:Medial	nci:Medial	0.5
fma:Extensor_carpi_ulnaris	nci:Extensor_Carpi_Ulnaris	0.59
fma:Nasal_cartilage	nci:Nasal_Cartilage	0.56
fma:Anterior_surface_of_stomach	nci:Anterior_Surface_of_the_Stomach	0.53
fma:Neuropil	nci:Neuropil	0.55
fma:Choroid_plexus_of_third_ventricle	nci:Choroid_Plexus_of_the_Third_Ventricle	0.53
fma:Urinary_bladder	nci:Bladder	0.65
fma:Radial_nerve	nci:Radial_Nerve	0.57
fma:Gingival_margin	nci:Gingival_Margin	0.5
fma:Synoviocyte	nci:Synovial_Cell	0.59
fma:Proximal_phalanx_of_finger	nci:Proximal_Phalanx_of_the_Hand	0.5
fma:Troponin_I	nci:Troponin-I	0.5
fma:Right_uterine_tube	nci:Right_Fallopian_Tube	0.66
fma:Canal_of_Volkmann	nci:Perforating_Canal	0.55
fma:Body_of_rib	nci:Rib_Shaft	0.46
fma:Osteoblast	nci:Osteoblast	0.64
fma:Branch_of_middle_cerebral_artery	nci:Middle_Cerebral_Artery_Branch	0.7
fma:Proerythroblast	nci:Proerythroblast	0.65
fma:Lower_eyelid	nci:Lower_Eyelid	0.6
fma:Ophthalmic_artery	nci:Opthalmic_Artery	0.53
fma:Set_of_gastric_glands	nci:Fundic_Gland	0.56
fma:Anterior_mediastinum	nci:Anterior_Mediastinum	0.56
fma:Lipid	nci:Lipid	0.5
fma:Sacral_nerve_plexus	nci:Sacral_Plexus	0.58
fma:Transverse_facial_artery	nci:Transverse_Facial_Artery	0.59
fma:Calcium_binding_protein	nci:Calcium_Binding_Protein	0.58
fma:Subscapular_artery	nci:Subscapular_Artery	0.57
fma:Cheek	nci:Cheek	0.55
fma:Amygdala	nci:Amygdala	0.54
fma:Nerve_root	nci:Nerve_Root	0.51
fma:Set_of_spaces_of_iridocorneal_angle	nci:Space_of_Fontana	0.49
fma:Pericardium	nci:Pericardium	0.56
fma:Root_of_nail	nci:Root_of_the_Nail	0.48
fma:Tonsillar_ring	nci:Waldeyers_Tonsillar_Ring	0.5
fma:Juxtaglomerular_complex	nci:Juxtaglomerular_Apparatus	0.62
fma:Lymphoid_nodule_of_spleen	nci:Splenic_White_Pulp	0.29
fma:Infraspinatus_muscle	nci:Infraspinatus	0.55
fma:Hyo_epiglottic_ligament	nci:Hyoepiglottic_Ligament	0.62
fma:Conjunctiva	nci:Conjunctiva	0.54
fma:Epinephrine	nci:Therapeutic_Epinephrine	0.5
fma:Endocardium	nci:Endocardium	0.54
fma:Duct	nci:Duct	0.67
fma:Cardiac_myocyte	nci:Cardiocyte	0.57
fma:Monosaccharide	nci:Monosaccharide	0.66
fma:Peritoneal_macrophage	nci:Peritoneal_Macrophage	0.71
fma:Peripheral_blood_mononuclear_cell	nci:Peripheral_Blood_Mononuclear_Cell	0.64
fma:Cysteine	nci:Cysteine	0.55
fma:Hip	nci:Hip	0.56
fma:Actin_filament	nci:Myofilament	0.45
fma:Squamous_cell	nci:Squamous_Cell	0.55
fma:Retromolar_triangle	nci:Retromolar_Trigone	0.44
fma:Lateral_sulcus	nci:Lateral_Sulcus_of_Sylvius	0.42
fma:Lesser_trochanter	nci:Lesser_Trochanter	0.54
fma:Extensor_carpi_radialis_brevis	nci:Extensor_Carpi_Radialis_Brevis	0.59
fma:Spinal_nerve	nci:Spinal_Nerve	0.89
fma:Membrane_protein_of_mitochondrion	nci:Mitochondrial_Membrane_Protein	0.57
fma:Celiac_lymph_node	nci:Celiac_Lymph_Node	0.69
fma:Prostatic_urethra	nci:Prostatic_Portion_of_the_Male_Urethra	0.56
fma:Terminal_sulcus	nci:Sulcus_Terminalis	0.5
fma:Bronchial_artery	nci:Bronchial_Artery	0.55
fma:Epithelium_of_urethra	nci:Urethra_Epithelium	0.74
fma:Thyro_epiglottic_ligament	nci:Thyroepiglottic_Ligament	0.62
fma:Afferent_neuron	nci:Sensory_Neuron	0.62
fma:Pericyte	nci:Pericyte	0.65
fma:Set_of_lobules_of_thymus	nci:Thymic_Lobule	0.42
fma:Sinus	nci:Sinus	0.5
fma:Periosteum	nci:Periosteum	0.51
fma:Posterior_tibial_artery	nci:Posterior_Tibial_Artery	0.58
fma:Brush_cell	nci:Brush_Cell	0.66
fma:Anterior_surface_of_kidney	nci:Anterior_Surface_of_the_Kidney	0.53
fma:Buccal_mucosa	nci:Buccal_Mucosa	0.58
fma:Renal_fascia	nci:Renal_Capsule	0.54
fma:Dendritic_cell	nci:Dendritic_Cell	0.71
fma:Amniotic_cavity	nci:Amniotic_Cavity	0.5
fma:Superior_hypophysial_artery	nci:Superior_Hypophyseal_Artery	0.57
fma:Set_of_coeliac_ganglia	nci:Coeliac_Ganglion	0.51
fma:Endothelial_cell	nci:Endothelial_Cell	0.56
fma:Collagen_fibril	nci:Collagen_Fibril	0.56
fma:Set_of_prostatic_ducts	nci:Prostatic_Duct	0.55
fma:Serosa	nci:Serosa	0.63
fma:Cementoblast	nci:Cementoblast	0.64
fma:Testicular_artery	nci:Spermatic_Artery	0.65
fma:Conchal_part_of_pinna	nci:Concha	0.54
fma:Abdomen	nci:Abdominal	0.32
fma:Posterior_limiting_lamina_of_cornea	nci:Descemet_s_Membrane	0.56
fma:Areola	nci:Areola	0.54
fma:Body_of_gallbladder	nci:Gallbladder_Body	0.56
fma:Pectoralis_minor	nci:Pectoralis_Minor	0.67
fma:Cardiovascular_system	nci:Cardiovascular_System	0.68
fma:Prostatic_utricle	nci:Utricle	0.43
fma:Medulla_oblongata	nci:Medulla_Oblongata	0.55
fma:Pulmonary_vein	nci:Pulmonary_Vein	0.57
fma:Brown_adipose_tissue	nci:Brown_Adipose_Tissue	0.71
fma:Anterior_median_fissure_of_spinal_cord	nci:Anterior_Median_Fissure_of_Spinal_Cord	0.5
fma:Renal_artery	nci:Renal_Artery	0.65
fma:Line	nci:Line	0.5
fma:Myelin_sheath	nci:Myelin	0.47
fma:Autonomic_ganglion	nci:Autonomic_Ganglion	0.91
fma:Palatoglossus	nci:Palatoglossus_Muscle	0.66
fma:Pacinian_corpuscle	nci:Vater-Pacini_Corpuscle	0.55
fma:Intercalated_disc	nci:Intercalated_Disk	0.55
fma:Hyaline_cartilage	nci:Hyaline_Cartilage	0.77
fma:Ovarian_artery	nci:Ovarian_Artery	0.57
fma:Lateral_sulcus	nci:Fissure_of_Sylvius	0.5
fma:Median_thyrohyoid_ligament	nci:Middle_Thyrohyoid_Ligament	0.64
fma:Ileocolic_vein	nci:Ileocolic_Vein	0.59
fma:Nasal_muscle	nci:Nasal_Muscle	0.62
fma:Popliteal_artery	nci:Popliteal_Artery	0.58
fma:Ascending_colon	nci:Ascending_Colon	0.55
fma:Geniohyoid	nci:Geniohyoid	0.63
fma:Periosteal_cell	nci:Periosteal_Cell	0.5
fma:Pinna	nci:Auricle	0.55
fma:Suprarenal_vein	nci:Suprarenal_Vein	0.65
fma:Parieto_occipital_sulcus	nci:Parieto-occipital_Fissure	0.5
fma:Circular_sulcus_of_insula	nci:Circular_Sulcus	0.45
fma:Optic_nerve	nci:Optic_Nerve	0.67
fma:Trigeminal_ganglion	nci:Trigeminal_Ganglion	0.62
fma:Argentaffin_cell	nci:Enterochromaffin_Cell	0.29
fma:Melanin	nci:Melanin	0.57
fma:Basilar_artery	nci:Basilar_Artery	0.58
fma:Branch_of_posterior_tibial_artery	nci:Posterior_Tibial_Artery_Branch	0.51
fma:Integumentary_system	nci:Skin	0.45
fma:Stroma	nci:Stroma	0.5
fma:Dopamine	nci:Dopamine_Base	0.5
fma:Lateral_aperture_of_fourth_ventricle	nci:Foramen_of_Luschka	0.5
fma:Vulva	nci:Vulva	0.56
fma:Cochlear_labyrinth	nci:Cochlear_Labyrinth	0.55
fma:Set_of_thoracic_lymph_nodes	nci:Thoracic_Lymph_Node	0.5
fma:Optic_chiasm	nci:Chiasma	0.56
fma:Semen	nci:Semen	0.59
fma:Erythroblast	nci:Nucleated_Red_Blood_Cell	0.12
fma:Inferior_mesenteric_artery	nci:Inferior_Mesenteric_Artery	0.58
fma:Bulbo_urethral_gland	nci:Cowper_s_Gland	0.6
fma:Tertiary_follicle_of_ovary	nci:Graafian_Follicle	0.61
fma:Internal	nci:Internal	0.5
fma:Chondroblast	nci:Chondroblast	0.65
fma:Myelinated_nerve_fiber	nci:Myelinated_Nerve_Fiber	0.61
fma:Astrocyte	nci:Astrocyte	0.75
fma:Dorsal_nasal_artery	nci:Dorsal_Nasal_Artery	0.55
fma:Cranial_nerve	nci:Cranial_Nerve	0.92
fma:Amino_acid	nci:Amino_Acid	0.69
fma:Follicular_cell_of_ovary	nci:Follicular_Ovarian_Cell	0.62
fma:Teres_minor	nci:Teres_Minor_Muscle	0.57
fma:Middle_lobe_of_lung	nci:Middle_Lobe_of_the_Right_Lung	0.6
fma:Hepatic_stem_cell	nci:Liver_Stem_Cell	0.67
fma:Endosome	nci:Endosome	0.8
fma:Left_subclavian_artery	nci:Left_Subclavian_Artery	0.63
fma:Male_breast	nci:Male_Breast	0.61
fma:Superior_medullary_velum	nci:Valve_of_Vieussens	0.05
fma:Macula_densa	nci:Macula_Densa	0.55
fma:Neurotendinous_ending	nci:Golgi_Tendon_Organ	0.55
fma:Langerhans_cell	nci:Langerhans_Cell	0.63
fma:Pia_mater	nci:Pia_Mater	0.57
fma:Pericardial_sac	nci:Pericardium	0.42
fma:Skull_bone	nci:Skull	0.51
fma:Lesser_tubercle_of_humerus	nci:Lesser_Tuberosity	0.53
fma:Transitional_cell	nci:Transitional_Cell	0.5
fma:Hair_shaft	nci:Shaft_of_the_Hair	0.44
fma:Anatomical_lobe	nci:Lobe	0.33
fma:Fatty_acid	nci:Fatty_Acid	0.53
fma:Adenohypophysis	nci:Anterior_Lobe_of_the_Pituitary_Gland	0.56
fma:Scrotum	nci:Scrotum	0.55
fma:Frontal_nerve	nci:Frontal_Nerve	0.57
fma:Finger	nci:Finger	0.59
fma:Synovial_membrane	nci:Synovial_Membrane	0.53
fma:Cell_body_of_neuron	nci:Perikaryon	0.55
fma:Corpus_striatum	nci:Striatum	0.36
fma:Glucuronic_acid	nci:Glucuronic_Acid	0.5
fma:Nipple	nci:Nipple	0.54
fma:Pyloric_gland	nci:Pyloric_Gland	0.62
fma:Inner_part_of_external_acoustic_tube	nci:Pars_Interna	0.53
fma:Ground_substance	nci:Ground_Substance	0.5
fma:Low_density_lipoprotein	nci:Low_Density_Lipoprotein	0.57
fma:Subdivision_of_superior_mesenteric_artery	nci:Superior_Mesenteric_Artery_Branch	0.62
fma:Steroid_hormone	nci:Steroid_Hormone	0.57
fma:Cerebral_hemisphere	nci:Cerebral_Hemisphere	0.63
fma:Vestibular_fold	nci:False_Vocal_Cord	0.55
fma:Neural_stem_cell	nci:Neural_Stem_Cell	0.66
fma:Axillary_lymph_node	nci:Axillary_Lymph_Node	0.55
fma:Great_saphenous_vein	nci:Long_Saphenous_Vein	0.58
fma:Lens	nci:Crystalline_Lens	0.55
fma:Set_of_papillae_of_tongue	nci:Papilla_of_the_Tongue	0.56
fma:Submucosa_of_trachea	nci:Trachea_Submucosa	0.55
fma:Lutropin	nci:Therapeutic_Luteinizing_Hormone	0.5
fma:Skin_of_neck	nci:Neck_Skin	0.67
fma:Mammotroph	nci:Lactotrope_Cell	0.71
fma:Valve_of_inferior_vena_cava	nci:Eustachian_Valve	0.66
fma:Biliary_tree	nci:Biliary_Tract	0.54
fma:Serotonin	nci:Serotonin	0.5
fma:Set_of_extra_ocular_muscles	nci:Oculomotor_Muscle	0.27
fma:Falx_cerebelli	nci:Falx_Cerebelli	0.56
fma:Leucine	nci:Leucine	0.5
fma:Musculature_of_perineum	nci:Perineal_Muscle	0.54
fma:Perianal_skin	nci:Anal_Margin	0.65
fma:Intermediate_trophoblast_cell	nci:Intermediate_Trophoblast	0.66
fma:T_lymphocyte	nci:T-Lymphocyte	0.7
fma:Pancreaticoduodenal_vein	nci:Pancreatico-Duodenal_Vein	0.58
fma:Natural_killer_cell	nci:Natural_Killer_Cell_Retired	0.5
fma:Groove_for_inferior_vena_cava	nci:Fissure_of_the_Inferior_Vena_Cava	0.22
fma:Neck_of_gallbladder	nci:Gallbladder_Neck	0.56
fma:Spiral_organ_of_cochlea	nci:Spiral_Organ_of_Corti	0.5
fma:Bone_marrow	nci:Bone_Marrow	0.65
fma:Dorsal_nucleus_of_vagus_nerve	nci:Dorsal_Nucleus_of_the_Vagus_Nerve	0.55
fma:Promonocyte	nci:Promonocyte	0.62
fma:Submucosa	nci:Submucosa	0.65
fma:Basal_part_of_pons	nci:Pontine_Base	0.55
fma:Pleural_cavity	nci:Pleural_Cavity	0.56
fma:Muscle	nci:Muscle_Tissue	0.5
fma:Posterior_cranial_fossa	nci:Posterior_Fossa	0.5
fma:Goblet_cell_of_small_intestine	nci:Small_Intestinal_Goblet_Cell	0.78
fma:Lingual_tonsil	nci:Lingual_Tonsil	0.61
fma:Ribosome	nci:Ribosome	0.76
fma:Vermiform_granule	nci:Birbeck_Granule	0.61
fma:Lumbar_artery	nci:Lumbar_Artery	0.55
fma:Stomach	nci:Stomach	0.65
fma:Chest_wall	nci:Chest_Wall	0.55
fma:Paneth_cell	nci:Paneth_Cell	0.66
fma:Cranial_dura_mater	nci:Cerebral_Dura_Mater	0.55
fma:Juxtaglomerular_cell	nci:Juxtaglomerular_Cell	0.61
fma:Striated_border	nci:Striated_Border	0.55
fma:Arm	nci:Arm	0.55
fma:Proximal	nci:Nearest	0.0
fma:Estrogen	nci:Estrogen	0.59
fma:Anterior_communicating_artery	nci:Anterior_Communicating_Artery	0.63
fma:Internal	nci:Inner	0.0
fma:Meningothelial_cell	nci:Meningothelial_Cell	0.61
fma:Alveolar_epithelial_cell	nci:Alveolar_Cell	0.75
fma:Megakaryocyte	nci:Megakaryocyte	0.64
fma:Pupil	nci:Pupil	0.5
fma:Betaglycan	nci:Transforming_Growth_Factor_Beta_Receptor-III	0.5
fma:Surface_ectoderm	nci:Surface_Ectoderm	0.68
fma:Lateral_cerebellomedullary_cistern	nci:Inferior_Cerebellopontine_Cistern	0.56
fma:Anterior_perforated_substance	nci:Posterior_Olfactory_Lobule	0.55
fma:Nucleus_of_brain	nci:Brain_Nucleus	0.63
fma:Internal_ear	nci:Internal_Ear	0.55
fma:Pectoralis_major	nci:Pectoralis_Major	0.67
fma:Bone_of_lunate	nci:Lunate_Bone	0.52
fma:Chief_cell_of_stomach	nci:Chief_Cell_of_the_Stomach	0.74
fma:Splenic_pulp	nci:Splenic_Pulp	0.62
fma:Norepinephrine	nci:Norepinephrine_Base	0.5
fma:Testicular_vein	nci:Spermatic_Vein	0.65
fma:Crest	nci:Crest	0.5
fma:Cytoskeletal_filament	nci:Filament	0.71
fma:Forebrain	nci:Fore-Brain	0.55
fma:Right_lung	nci:Right_Lung	0.69
fma:Decidua	nci:Decidua	0.55
fma:Skin_of_foot	nci:Foot_Skin	0.62
fma:Patella	nci:Patella	0.61
fma:Rectum	nci:Rectum	0.56
fma:Bone_of_hamate	nci:Hamate_Bone	0.52
fma:Left_kidney	nci:Left_Kidney	0.68
fma:Transitional_epithelial_cell_of_urinary_bladder	nci:Bladder_Transitional_Cell	0.7
fma:Postcentral_gyrus	nci:Postcentral_Gyrus	0.54
fma:Special_sense_organ_system	nci:Special_Sense_Organ_System	0.56
fma:Plantar_metatarsal_artery	nci:Plantar_Metatarsal_Artery	0.66
fma:Sarcoplasmic_reticulum	nci:Sarcoplasmic_Reticulum	0.61
fma:Perineurium	nci:Perineurium	0.71
fma:Segment_of_palm	nci:Palmar_Region	0.25
fma:Gamma_motor_neuron	nci:Gamma_Motor_Neuron	0.7
fma:Vestibular_labyrinth	nci:Vestibular_Labyrinth	0.55
fma:Labium_majus	nci:Labium_Majus	0.54
fma:Erector_spinae_muscle_group	nci:Erector_Spinae	0.56
fma:Superior_anastomotic_vein	nci:Superior_Anastomotic_Vein_of_the_Trolard	0.58
fma:Set_of_muscles_of_abdomen	nci:Abdominal_Muscle	0.33
fma:Cytoplasmic_inclusion	nci:Cytoplasmic_Inclusion	0.55
fma:Left_adrenal_gland	nci:Left_Adrenal_Gland	0.66
fma:Cell_to_matrix_adherens_junction	nci:Cell-to-extracellular_Matrix_Junction	0.6
fma:Set_of_lumbar_arteries	nci:Lumbar_Artery	0.5
fma:Capsule_of_ovary	nci:Ovarian_Capsule	0.55
fma:Circumflex_branch_of_left_coronary_artery	nci:Circumflex_Branch_of_the_Left_Coronary_Artery	0.68
fma:Malleus	nci:Malleus	0.59
fma:Epiphysis	nci:Epiphysis_of_the_Bone	0.41
fma:Upper_lobe_of_left_lung	nci:Upper_Lobe_of_the_Left_Lung	0.62
fma:Somatotroph	nci:Somatotrope_Cell	0.71
fma:Motor_neuron	nci:Motor_Neuron	0.65
fma:Cuboidal_cell	nci:Cuboidal_Cell	0.59
fma:Sacral_nerve	nci:Sacral_Nerve	0.6
fma:Splenial_artery	nci:Splenial_Artery	0.66
fma:Lateral_rectus	nci:Lateral_Rectus_Muscle	0.6
fma:Root_of_tooth	nci:Radix_Dentis	0.51
fma:Superior_temporal_sulcus	nci:Superior_Temporal_Sulcus	0.5
fma:Gray_matter_of_neuraxis	nci:Gray_Matter	0.58
fma:Bone_marrow_cell	nci:Bone_Marrow_Blood-Forming_Cell	0.49
fma:Falciform_ligament	nci:Falciform_Ligament	0.55
fma:Crest	nci:Ridge	0.5
fma:Exocrine_pancreas	nci:Exocrine_Pancreas	0.56
fma:Vertebral_arch_joint	nci:Facet_Joint	0.53
fma:Common_hepatic_duct	nci:Common_Hepatic_Duct	0.72
fma:Crown_of_tooth	nci:Corona_Dentis	0.51
fma:Set_of_interphalangeal_joints_of_hand	nci:Interphalangeal_Joint_of_the_Hand	0.49
fma:Heterochromatin	nci:Heterochromatin	0.61
fma:Heparin	nci:Heparin	0.5
fma:Tooth	nci:Tooth	0.74
fma:Midbrain	nci:Mesencephalon	0.55
fma:Lymphatic_system	nci:Lymphatic_System	0.5
fma:Lipid_bilayer_of_plasma_membrane	nci:Plasma_Membrane_Lipid_Bilayer	0.62
fma:Lymph_node	nci:Lymph_Node	0.82
fma:Urine	nci:Urine	0.59
fma:Subsegmental_bronchus	nci:Subsegmental_Bronchus	0.52
fma:Fascia_cluster	nci:Fascia	0.52
fma:Central_tendon	nci:Central_Tendon_of_the_Diaphragm	0.56
fma:Pancreatic_acinus	nci:Pancreatic_Acinus	0.55
fma:Blast_cell	nci:Blast_Cell	0.5
fma:Fucose	nci:Fucose	0.59
fma:Seminal_fluid	nci:Seminal_Fluid	0.5
fma:Set_of_neuroglial_cells	nci:Glial_Cell	0.59
fma:Retroperitoneal_compartment	nci:Retroperitoneal	0.42
fma:Lingual_artery	nci:Lingual_Artery	0.71
fma:Articular_cartilage	nci:Articular_Cartilage	0.52
fma:Immune_system	nci:Immune_System	0.5
fma:Muscularis_mucosae_of_esophagus	nci:Esophageal_Muscularis_Mucosa	0.55
fma:Posterior_tibial_vein	nci:Posterior_Tibial_Vein	0.54
fma:Glenoid_fossa	nci:Glenoid_Fossa	0.5
fma:Rhomboid_fossa_of_fourth_ventricle	nci:Floor_of_the_Fourth_Ventricle	0.48
fma:Superficial_fascia	nci:Superficial_Fascia	0.61
fma:Set_of_sigmoid_arteries	nci:Sigmoid_Artery	0.5
fma:Vagus_nerve	nci:Vagus_Nerve	0.58
fma:Branch_of_anterior_cerebral_artery	nci:Anterior_Cerebral_Artery_Branch	0.66
fma:Submucosa_of_large_intestine	nci:Large_Intestinal_Submucosa	0.61
fma:Serosa_of_uterus	nci:Perimetrium	0.55
fma:Right	nci:Right	0.5
fma:Spermatid	nci:Spermatid	0.72
fma:Fascicle	nci:Fascicle	0.5
fma:Set_of_cavities	nci:Body_Cavity	0.17
fma:Subcutaneous_adipose_tissue	nci:Subcutis	0.61
fma:Main_bronchus	nci:Main_Bronchus	0.69
fma:Skin_of_head	nci:Head_Skin	0.67
fma:Set_of_axillary_lymph_nodes	nci:Axillary_Lymph_Node	0.6
fma:Gastrointestinal_tract	nci:Gastrointestinal_Tract	0.56
fma:Golgi_complex	nci:Golgi_Apparatus	0.7
fma:Inner_nuclear_membrane	nci:Nuclear_Inner_Membrane	0.61
fma:Decidua_basalis	nci:Decidua_Basalis	0.56
fma:Prostatic_epithelium	nci:Prostatic_Epithelium	0.7
fma:Rectovesical_pouch	nci:Recto-Vesical_Pouch	0.5
fma:Lobule_of_pinna	nci:Lobule_of_the_Auricle	0.51
fma:Iliolumbar_vein	nci:Iliolumbar_Vein	0.58
fma:Cochlear_nerve	nci:Cochlear_Nerve	0.57
fma:Node_of_Ranvier	nci:Node_of_Ranvier	0.55
fma:Renal_interstitial_cell	nci:Renal_Interstitial_Cell	0.5
fma:Left_hepatic_duct	nci:Left_Hepatic_Duct	0.67
fma:Interstitial_cell_of_Cajal	nci:Interstitial_Cell_of_Cajal	0.6
fma:Left_common_iliac_artery	nci:Left_Common_Iliac_Artery	0.63
fma:Thyrotroph	nci:Thyrotroph_Cell	0.5
fma:N_cadherin	nci:N-Cadherin	0.64
fma:Hemopoietic_tissue	nci:Hematopoietic_Tissue	0.63
fma:Maxillary_artery	nci:Maxillary_Artery	0.55
fma:Pars_tuberalis_of_adenohypophysis	nci:Pituitary_Stalk	0.09
fma:Hard_palate	nci:Hard_Palate	0.56
fma:External_iliac_artery	nci:External_Iliac_Artery	0.57
fma:Fibronectin	nci:Fibronectin	0.5
fma:Neurohypophysis	nci:Posterior_Lobe_of_the_Pituitary_Gland	0.56
fma:Left_lobe_of_thyroid_gland	nci:Left_Thyroid_Gland_Lobe	0.59
fma:Loop_of_Henle	nci:Loop_of_Henle	0.6
fma:Set_of_toes	nci:Toe	0.45
fma:Cochlear_inner_hair_cell	nci:Type_I_Hair_Cell	0.75
fma:Muscle_of_palate	nci:Palatal_Muscle	0.61
fma:Anterior_pole_of_lens	nci:Anterior_Pole_of_the_Lens	0.52
fma:Central_canal_of_spinal_cord	nci:Central_Canal	0.55
fma:Fundus_of_urinary_bladder	nci:Bladder_Fundus	0.52
fma:Common_bile_duct	nci:Common_Bile_Duct	0.71
fma:N_acetylneuraminic_acid	nci:Sialic_Acid	0.11
fma:Radius	nci:Radius_Bone	0.62
fma:Dorsal_metatarsal_vein	nci:Dorsal_Metatarsal_Vein	0.53
fma:Internal_thoracic_vein	nci:Internal_Thoracic_Vein	0.58
fma:Subclavius	nci:Subclavius	0.59
fma:Inferior_hypophysial_artery	nci:Inferior_Hypophyseal_Artery	0.62
fma:Type_IV_taste_bud_cell	nci:Taste_Bud_Basal_Cell	0.73
fma:Gastrocolic_ligament	nci:Gastrocolic_Ligament	0.55
fma:Right_surface_of_liver	nci:Lateral_Surface_of_the_Liver	0.56
fma:Set_of_subendocardial_branches_of_atrioventricular_bundle	nci:Purkinje_Fiber	0.42
fma:Plasma_membrane	nci:Plasma_Membrane	0.52
fma:Phalanx_of_toe	nci:Phalanx_of_the_Foot	0.46
fma:Anterolateral	nci:Anterolateral	0.5
fma:Hand	nci:Hand	0.55
fma:Trapezius	nci:Trapezius_Muscle	0.52
fma:Set_of_intercarpal_joints	nci:Carpal_Joint	0.54
fma:Superior_frontal_gyrus	nci:Superior_Frontal_Gyrus	0.54
fma:Photoreceptor	nci:Photoreceptor_Cell	0.54
fma:Calcarine_artery	nci:Calcarine_Artery	0.66
fma:Set_of_eyebrows	nci:Eyebrow	0.48
fma:Neuroendocrine_cell	nci:Neuroendocrine_Cell	0.56
fma:Tectal_plate	nci:Quadrigeminal_Body	0.43
fma:Type_2_muscle_cell	nci:Muscle_Fibers_Fast-Twitch	0.53
fma:Cell	nci:Normal_Cell	0.5
fma:Phospholipid	nci:Phospholipid	0.55
fma:Ascending_part_of_duodenum	nci:Fourth_Portion_of_the_Duodenum	0.56
fma:Segment_of_leg	nci:Leg	0.36
fma:Epithelial_cell_of_thymus	nci:Thymic_Epithelial_Cell	0.63
fma:Superior_mesenteric_artery	nci:Superior_Mesenteric_Artery	0.58
fma:Posterior_nucleus_of_thalamus	nci:Posterior_Nucleus_of_the_Thalamus	0.57
fma:Sensory_neuron	nci:Sensory_Neuron	0.63
fma:Integrin	nci:Integrin	0.58
fma:Descending_thoracic_aorta	nci:Thoracic_Aorta	0.49
fma:Lower_segment_of_hair_follicle	nci:Hair_Follicle_Inferior_Segment	0.53
fma:Median_aperture_of_fourth_ventricle	nci:Foramen_of_Magendie	0.5
fma:Rough_endoplasmic_reticulum	nci:Rough_Endoplasmic_Reticulum	0.65
fma:Haversian_canal	nci:Haversian_Canal	0.55
fma:Set_of_glands	nci:Gland	0.61
fma:Hepatic_acinus	nci:Liver_Acinus	0.18
fma:Ectoderm	nci:Ectoderm	0.71
fma:Mediastinum	nci:Mediastinum	0.56
fma:Labial_part_of_mouth	nci:Lip	0.51
fma:Skin_of_wrist	nci:Wrist_Skin	0.62
fma:Horizontal_part_of_duodenum	nci:Third_Portion_of_the_Duodenum	0.48
fma:Head	nci:Head	0.68
fma:Squamous_cell_of_epidermis	nci:Skin_Squamous_Cell	0.78
fma:Prostatic_duct	nci:Prostatic_Duct	0.69
fma:Clitoris	nci:Clitoris	0.55
fma:Uterus	nci:Uterus	0.64
fma:Hilum_of_spleen	nci:Splenic_Hilum	0.5
fma:Temporal_lobe	nci:Temporal_Lobe	0.54
fma:Giant_cell	nci:Giant_Cell	0.5
fma:Membranous_cytoplasmic_organelle	nci:Membranous_Cytoplasmic_Organelle	0.79
fma:Embryonic_tissue	nci:Embryonic_Tissue	0.7
fma:Dorsal_root	nci:Dorsal_Root_of_the_Spinal_Nerve	0.37
fma:Sympathetic_nervous_system	nci:Sympathetic_Nervous_System	0.5
fma:Set_of_nails_of_toes	nci:Toe_Nail	0.48
fma:Neck_of_femur	nci:Femoral_Neck	0.55
fma:Nail	nci:Nail_Plate	0.52
fma:Set_of_auditory_ossicles	nci:Auditory_Ossicle	0.49
fma:Extensor_carpi_radialis_longus	nci:Extensor_Carpi_Radialis_Longus	0.59
fma:Set_of_medullary_rays_of_kidney	nci:Pyramid_of_Ferrein	0.41
fma:Set_of_vertebral_joints	nci:Vertebral_Joint	0.54
fma:Entactin	nci:Nidogen	0.5
fma:Posterior_wall_of_oropharynx	nci:Posterior_Wall_of_the_Oropharynx	0.56
fma:Posterior_inferior_cerebellar_artery	nci:Posterior_Inferior_Cerebellar_Artery	0.66
fma:T_lymphoblast	nci:T-Lymphoblast	0.55
fma:Spermatic_cord	nci:Spermatic_Cord	0.56
fma:Epicardium	nci:Epicardium	0.56
fma:Hip_joint	nci:Hip_Joint	0.62
fma:Subthalamus	nci:Ventral_Thalamus	0.55
fma:Basal_cell_layer_of_epidermis	nci:Stratum_Basale	0.46
fma:Sertoli_cell	nci:Sertoli_Cell	0.6
fma:Blood_vessel	nci:Blood_Vessel	0.5
fma:Saccule_of_membranous_labyrinth	nci:Saccule	0.55
fma:Rhamnose	nci:Rhamnose	0.59
fma:Left_coronary_artery	nci:Left_Coronary_Artery	0.63
fma:Posterior_surface_of_kidney	nci:Kidney_Posterior_Surface	0.48
fma:Trabecula_of_lymph_node	nci:Lymph_Node_Trabecula	0.55
fma:Myo_inositol	nci:Inositol	0.5
fma:Posterior_mediastinum	nci:Posterior_Mediastinum	0.56
fma:Orbital_part_of_inferior_frontal_gyrus	nci:Orbital_Part_of_the_Inferior_Frontal_Gyrus	0.53
fma:Lip	nci:Lip	0.55
fma:Epiglottis	nci:Epiglottis	0.56
fma:Hypoglossal_nerve	nci:Hypoglossal_Nerve	0.58
fma:Putamen	nci:Putamen	0.54
fma:Arcuate_nucleus_of_hypothalamus	nci:Arcuate_Nucleus	0.59
fma:Cerebral_crus	nci:Crus_Cerebri	0.54
fma:Apocrine_sweat_gland	nci:Apocrine_Sweat_Gland	0.68
fma:Nucleus_accumbens	nci:Accumbens_Nucleus	0.58
fma:Embryo	nci:Embryo	0.6
fma:Pulmonary_lobule	nci:Pulmonary_Acinus	0.34
fma:Gonad	nci:Gonad	0.5
fma:Lutein_cell	nci:Lutein_Cell	0.67
fma:Spinal_nucleus_of_trigeminal_nerve	nci:Nucleus_of_the_Spinal_Tract_of_the_Trigeminal_Nerve	0.52
fma:Oligodendroglia	nci:Oligodendroglia_Cell	0.59
fma:Skin_of_arm	nci:Arm_Skin	0.62
fma:Vestibular_membrane_of_cochlear_duct	nci:Vestibular_Membrane	0.48
fma:Substantia_gelatinosa	nci:Substantia_Gelatinosa	0.54
fma:Thoracic_ganglion	nci:Thoracic_Ganglion	1.0
fma:Cytoskeleton	nci:Cytoskeleton	0.71
fma:Temporalis	nci:Temporal_Muscle	0.62
fma:Pericardiacophrenic_vein	nci:Pericardiacophrenic_Vein	0.58
fma:Substantia_propria_of_cornea	nci:Corneal_Stroma	0.49
fma:Muscle_of_tongue	nci:Tongue_Muscle	0.57
fma:Distal	nci:Distal	0.5
fma:Cauda_equina	nci:Cauda_Equina	0.55
fma:Enteroendocrine_cell	nci:Enteroendocrine_Cell	0.61
fma:Medial_geniculate_body	nci:Internal_Geniculate_Body	0.54
fma:Macula_of_saccule_of_membranous_labyrinth	nci:Macula_of_Saccule	0.55
fma:Common_iliac_lymph_node	nci:Iliac_Lymph_Node	0.65
fma:Anterior_choroidal_artery	nci:Anterior_Choroidal_Artery	0.62
fma:Sacrum	nci:Sacrum	0.55
fma:Extra_ocular_muscle	nci:Oculomotor_Muscle	0.45
fma:Cardiac_muscle_tissue	nci:Myocardium	0.49
fma:Anal_part_of_perineum	nci:Anal_Region	0.56
fma:Intestinal_mucosa	nci:Intestinal_Mucosa	0.54
fma:Ankle_joint	nci:Ankle_Joint	0.62
fma:Bone_of_talus	nci:Talus	0.38
fma:Set_of_nerve_plexuses	nci:Nerve_Plexus	0.51
fma:Saliva	nci:Saliva	0.58
fma:Nodular_lymphoid_tissue	nci:Lymphoid_Follicle	0.72
fma:Set_of_superior_suprarenal_arteries	nci:Superior_Suprarenal_Artery	0.53
fma:Breast	nci:Breast	0.74
fma:T_helper_lymphocyte	nci:Helper-Inducer_T-Lymphocyte	0.68
