Entity1	Entity2	Value
snomed:Body_system_structure	nci:Organ_System	0.56
snomed:Area_under_the_curve	nci:Area_under_Curve	0.5
snomed:Nicotine_patches	nci:Nicotine_Patch	0.48
snomed:Mesentery_structure	nci:Mesentery	0.42
snomed:Biological_substance	nci:Biological_Agent	0.44
snomed:Milk	nci:Milk	0.53
snomed:General_metabolic_function	nci:Intermediary_Metabolism	0.19
snomed:Disintegrations_per_minute	nci:Disintegration_per_Minute	0.58
snomed:Ricin	nci:Ricin	0.53
snomed:Chloride_salt	nci:Chlorine_Minus_1_Charge	0.48
snomed:Retroperitoneal_structure	nci:Retroperitoneum	0.39
snomed:Enzyme	nci:Enzyme	0.57
snomed:Yeast_form	nci:Yeast_Dried	0.41
snomed:Proton	nci:Proton	0.57
snomed:High_pressure_liquid_chromatography	nci:High_Performance-Liquid_Chromatography	0.6
snomed:Date_property	nci:Date_Value	0.35
snomed:Posterior	nci:Back	0.0
snomed:Small_intestinal	nci:Small_Intestine	0.46
snomed:Silybum_marianum_extract	nci:Milk_Thistle	0.0
snomed:Finding_of_sense_of_taste	nci:Gustation	0.19
snomed:Malignant_lymphoma_of_testis	nci:Testicular_Lymphoma	0.55
snomed:Window	nci:Window	0.5
snomed:Pseudogene	nci:Pseudogene	0.5
snomed:Male_structure	nci:Male	0.34
snomed:Ring_form_neutrophil	nci:Doughnut_Cell	0.0
snomed:Growth_factor	nci:Growth_Factor	0.61
snomed:Disorder_of_bone_development	nci:Bone_Development_Disorder	0.51
snomed:Drug_dependence	nci:Drug_Dependence	0.69
snomed:Sexual_behavior	nci:Sex_Behavior	0.56
snomed:Eltrombopag_olamine	nci:Eltrombopag	0.55
snomed:Method_of_sampling	nci:Type_of_Sample	0.19
snomed:Hepatocellular_carcinoma_scirrhous	nci:Sclerosing_Hepatocellular_Carcinoma	0.62
snomed:pM_category	nci:Distant_Metastasis	0.0
snomed:Epithelioid_cell_nevus	nci:Epithelioid_Cell_Nevus	0.68
snomed:Chemotherapy	nci:Chemotherapy	0.62
snomed:Endopeptidase	nci:Endopeptidase	0.55
snomed:Necrosis	nci:Necrotic	0.3
snomed:Striated_muscle_cell_atypia	nci:Striated_Muscle_Cell_Atypia	0.56
snomed:Disorder_of_skin	nci:Dermatosis	0.04
snomed:Cardiovascular_finding	nci:Cardiovascular_System_Finding	0.5
snomed:Antineoplastic_chemotherapy_regimen	nci:Chemotherapy_Regimen_New	0.37
snomed:Pancreatic_structure	nci:Pancreas	0.32
snomed:ohm	nci:Ohm	0.7
snomed:Fluorescence	nci:Fluorescence	0.5
snomed:Phthirus_pubis	nci:Pediculosis_Pubis	0.21
snomed:Hemostatic_function	nci:Hemostasis	0.25
snomed:Lung_surfactant	nci:Lung_Surfactant	0.5
snomed:Amniotic_cavity_infection_unspecified	nci:Amnionitis	0.15
snomed:Tissue_plasminogen_activator_preparation	nci:Tissue_Plasminogen_Activator	0.48
snomed:Gigabecquerel	nci:Gigabecquerel	0.68
snomed:Communicable_disease	nci:Infectious_Disease_Pathway	0.02
snomed:Recombinant_human_chorionic_gonadotrophin	nci:Therapeutic_Human_Chorionic_Gonadotropin	0.55
snomed:Granulation_tissue	nci:Granulation_Tissue	0.5
snomed:Genome	nci:Genome	0.5
snomed:White_color	nci:White_Color	0.55
snomed:Pericardiocentesis	nci:Pericardiocentesis	0.74
snomed:Laryngeal	nci:Laryngeal	0.59
snomed:Immunoglobulin	nci:Immunoglobulin	0.54
snomed:Diaphragm_structure	nci:Diaphragm	0.42
snomed:Colony_stimulating_factor_granulocytic	nci:Colony_Stimulating_Factor-3	0.52
snomed:Site	nci:Site	0.5
snomed:Pontine_structure	nci:Pontine	0.38
snomed:Oral_hygiene_finding	nci:Oral_Hygiene	0.43
snomed:Stages	nci:Stage_Generic	0.49
snomed:Urea_measurement	nci:Carbamide	0.33
snomed:Anti_DNA_antibody	nci:Recombinant_Humanized_IgG1k_Monoclonal_Antibody_TRC093	0.31
snomed:Inspiration	nci:Aspiration	0.42
snomed:Repeat	nci:Replicate	0.3
snomed:Treatment_intent	nci:Treat	0.43
snomed:Peru	nci:Per	0.45
snomed:Intramuscular_injection_NOS	nci:Intramuscular	0.44
snomed:Laboratory_test_result_abnormal	nci:Abnormal_Laboratory_Test	0.5
snomed:Sclerosis	nci:Sclerosis	0.5
snomed:Corn_of_toe	nci:Maize	0.38
snomed:Ascitic_fluid	nci:Peritoneal_Effusion	0.0
snomed:Meckel_s_diverticulum_NOS	nci:Meckel_Diverticulum	0.51
snomed:Pink_color	nci:Pink	0.43
snomed:Eltrombopag	nci:Eltrombopag_Base	0.55
snomed:Macrophage	nci:Histiocyte	0.09
snomed:Erythropoietin_preparation	nci:Erythropoietin	0.42
snomed:Pelvic	nci:Pelvis	0.43
snomed:Congenital_anomaly_of_cardiovascular_system	nci:Congenital_Cardiovascular_Abnormality	0.64
snomed:Grades	nci:Grade	0.47
snomed:Cannabis_dependence_episodic	nci:Cannabis_Dependence_Episodic_Use	0.69
snomed:Administration_of_drug_or_medicament	nci:Pharmacologic_Management	0.18
snomed:Lethargy	nci:Lethargic	0.43
snomed:Blood_cell	nci:Peripheral_Blood_Cell	0.55
snomed:Dorsal	nci:Dorsal	0.58
snomed:Corneal_disorder_NOS	nci:Eye_Cornea_MMHCC	0.35
snomed:Surgical_specialty	nci:Surgical_Specialty	0.59
snomed:Fruit	nci:Fruit	0.67
snomed:Contrast_radiology_of_lymphatic_tissue_NOS	nci:Lymphangiography	0.19
snomed:Ion	nci:Ions	0.5
snomed:Unit	nci:Unit_Property	0.5
snomed:Corn_of_toe	nci:Corn	0.55
snomed:Contagious_disease	nci:Infectious_Disorder	0.26
snomed:Fluoroscopic_myelogram	nci:Myelogram	0.3
snomed:Thrombolytic	nci:Thrombolytic_Agent	0.51
snomed:Disorder_of_artery	nci:Arterial_Disorder	0.43
snomed:Inorganic_chemical	nci:Inorganic_Chemical	0.69
snomed:Leukostasis	nci:Leukostasis	0.5
snomed:Variable	nci:Variable	0.5
snomed:Hemodialysis_route	nci:Hemodialysis	0.45
snomed:Imaging	nci:Diagnostic_Imaging	0.48
snomed:uIU	nci:Microinternational_Unit	0.78
snomed:Ganglioside_GMgt2lt	nci:Ganglioside_GM2	0.43
snomed:Antigen	nci:Antigen	0.54
snomed:Hyaline_casts	nci:Hyaline_Cast_Formation	0.48
snomed:Corneal_transplant	nci:Corneal_Transplant	0.5
snomed:Old_age	nci:Elderly	0.0
snomed:Subatomic_particle	nci:Subatomic_Particle	0.7
snomed:Water_product	nci:Nutrition_Water	0.0
snomed:kilocalorie	nci:Nutrition_Calories	0.39
snomed:Disorder_of_the_central_nervous_system	nci:Central_Nervous_System_Disorder	0.51
snomed:Mass	nci:Mass_Property	0.5
snomed:Apoptosis	nci:Apoptosis_Pathway	0.5
snomed:Disorder_of_pregnancy	nci:Pregnancy_Disorder	0.5
snomed:Echinacea_preparation	nci:Echinacea_Plant	0.39
snomed:Cell_structure	nci:Cell	0.44
snomed:Neoplasm_metastatic	nci:Metastasis	0.15
snomed:Histopathology	nci:Histopathology	0.5
snomed:Body_part_structure	nci:Body_Part	0.4
snomed:Obtained	nci:Obtain	0.6
snomed:Action	nci:Action	0.56
snomed:Cytolysis	nci:Cytolysis	0.5
snomed:State	nci:State	0.5
snomed:Activin_hormone	nci:Activin	0.4
snomed:Phagocytic_cell	nci:Phagocytic_Cell	0.61
snomed:Chromosome_inversion	nci:Inversion	0.32
snomed:Control	nci:Control	0.56
snomed:Mesentery_structure	nci:Mesenteric	0.31
snomed:Mass_of_body_structure	nci:Mass	0.33
snomed:Apple_flavor	nci:Apple	0.39
snomed:Receptor	nci:Receptor	0.57
snomed:Thoracic_cage_X_ray	nci:Chest_Radiography	0.2
snomed:Pulse_function	nci:Pulse	0.37
snomed:Lymphangiography_NOS	nci:Lymphography	0.47
snomed:Classes	nci:Class	0.45
snomed:Blocking	nci:Block_Activity	0.5
snomed:Mississippi	nci:Ms	0.0
snomed:Caucasian	nci:White	0.55
snomed:Pigmented_nevus_no_ICD_O_subtype	nci:Melanocytic_Nevus	0.24
snomed:Diagnostic_nuclear_medicine_NOS	nci:Scanning_Procedure_or_Technique	0.0
snomed:Sexual_behavior_finding	nci:Sex	0.24
snomed:Lack_of_energy	nci:Fatigue	0.56
snomed:Patient_discharge	nci:Discharge	0.44
snomed:Short	nci:Short_Value	0.5
snomed:Cerebral_meninges_structure	nci:Cerebral_Meninges	0.52
snomed:Route_of_administration_value	nci:Route	0.56
snomed:With_type	nci:Type	0.33
snomed:Meninges_disorder_NOS	nci:Meninges	0.38
snomed:Optical_illusion_function	nci:Optical_Illusion	0.44
snomed:Regular_insulin	nci:Insulin	0.39
snomed:Biomedical_equipment	nci:Device	0.0
snomed:Adhesion	nci:Adhesion	0.5
snomed:Chromosomal_anomalies_NOS	nci:Chromosome_Disorder	0.3
snomed:Class	nci:Class	0.5
snomed:Italians	nci:Italian	0.54
snomed:Complex	nci:Complexes	0.5
snomed:Eruption_of_skin	nci:Skin_Rash	0.17
snomed:Homo_sapiens	nci:Man	0.13
snomed:Dependent_drug_abuse	nci:Drug_Dependence	0.41
snomed:Metabolic_disease	nci:Metabolic_Disorder	0.54
snomed:Sexual_activity_NOS	nci:Sex_Behavior	0.36
snomed:Communicable_disease	nci:Infectious_Disorder	0.05
snomed:Disturbance_in_affect	nci:Mood_Alteration	0.0
snomed:Unit_of_radioactivity	nci:Unit_of_Radioactivity	0.68
snomed:Cigarette_smoker	nci:Cigarette_Smoker	0.5
snomed:Fourth	nci:Fourth_Name_Suffix	0.5
snomed:Bacterial_toxin	nci:Bacterial_Toxin	0.57
snomed:kat	nci:Katal	0.72
snomed:Caspase_1	nci:Ice	0.0
snomed:Free_radical	nci:Free_Radicals	0.55
snomed:Types	nci:Terminology_Kind	0.0
snomed:Infant_child	nci:Infant	0.41
snomed:ukat	nci:Microkatal	0.65
snomed:Digestive_tract_structure	nci:Gastrointestinal_Tract	0.44
snomed:Metastatic_squamous_cell_carcinoma	nci:Metastatic_Squamous_Cell_Carcinoma	0.58
snomed:Somatostatin	nci:Somatostatin	0.56
snomed:Neoplasm_metastatic	nci:Metastasize	0.12
snomed:Disorder_of_mediastinum	nci:Mediastinal_Disorder	0.46
snomed:Undescended_testis	nci:Undescended_Testis	0.5
snomed:N_category	nci:N_Stage	0.0
snomed:Unit_of_temperature	nci:Unit_of_Temperature	0.56
snomed:General_metabolic_function	nci:Metabolism	0.16
snomed:Necrosis	nci:Necrosis	0.5
snomed:Degenerative_disorder	nci:Degenerative_Disorder	0.51
snomed:Laryngeal	nci:Larynx	0.35
snomed:Chloramphenicol_acetyltransferase	nci:Cat	0.0
snomed:Ulcer	nci:Ulceration	0.4
snomed:Blood_vessel_structure	nci:Blood_Vessel	0.44
snomed:Chest_infection	nci:Lower_Respiratory_Tract_Infection	0.26
snomed:Teaching_principal	nci:Principal	0.35
snomed:Secondary_Ca_NOS	nci:Metastasize	0.0
snomed:Autoimmune	nci:Autoimmune_Process	0.62
snomed:Fibrin	nci:Fibrin	0.5
snomed:Cannabis_dependence_unspecified	nci:Cannabis_Dependence	0.61
snomed:Unit_of_volume	nci:Unit_of_Volume	0.76
snomed:Cancer_antigen_19_9	nci:CA19-9_Antigen	0.66
snomed:Pegfilgrastim	nci:Pegfilgrastim	0.68
snomed:Functional_disorder	nci:Pathophysiology	0.19
snomed:Body_surface_area	nci:Body_Surface_Area	0.5
snomed:Triglycerides_measurement	nci:Triglycerides	0.44
snomed:Postoperative_wound_infection	nci:Postoperative_Wound_Infection	0.56
snomed:Vernix_caseosa	nci:Vernix_Caseosa	0.5
snomed:Hallucinogen_dependence_continuous	nci:Hallucinogen_Dependence_Continuous_Use	0.71
snomed:Medium	nci:Medium_Material	0.5
snomed:Morphologic_finding	nci:Morphologic_Finding	0.52
snomed:Echography	nci:Ultrasound	0.0
snomed:Apocrine_cystadenoma	nci:Apocrine_Hydrocystoma	0.47
snomed:Thoracic	nci:Chest	0.0
snomed:Cocaine_dependence	nci:Cocaine_Dependence	0.71
snomed:Chloride_measurement	nci:Chloride	0.38
snomed:Iontophoresis_route	nci:Ions	0.25
snomed:Perception_function	nci:Perception	0.41
snomed:Autoimmune_reaction	nci:Autoimmune_Process	0.5
snomed:Colostrum	nci:Colostrum	0.56
snomed:Silicone	nci:Silicone	0.52
snomed:Melanocytic_nevus_of_skin	nci:Mole	0.0
snomed:Gene	nci:Gene	0.53
snomed:Diverticulum	nci:Diverticulum	0.61
snomed:Jaw_region_structure	nci:Jaw	0.27
snomed:Urethral_gland_structure	nci:Urethra_Gland_MMHCC	0.42
snomed:Back_region	nci:Back	0.42
snomed:Transmissible_disease	nci:Infectious_Disorder	0.02
snomed:Removal_of_soft_tissue	nci:Excision_of_Soft_Tissue	0.29
snomed:Tetracosactrin	nci:Cortrsyn	0.0
snomed:Hallucinogen_dependence	nci:Hallucinogen_Dependence	0.68
snomed:Corneal_disorder_NOS	nci:Corneal_Disorder	0.57
snomed:GAg_gene	nci:GAG_Gene	0.5
snomed:Thyrotropin_releasing_hormone_preparation	nci:Protirelin	0.28
snomed:Recombinant_urate_oxidase	nci:Rasburicase	0.5
snomed:Erythrocyte	nci:Erythrocyte	0.56
snomed:Extents	nci:Extent	0.48
snomed:Mixed	nci:Mix	0.41
snomed:Lymphoma_stage	nci:Lymphoma_by_Stage	0.49
snomed:Immunosuppressant	nci:Immunosuppressant	0.65
snomed:Laboratory_procedures_general	nci:Test	0.45
snomed:Erythrosin_B_stain	nci:FD_C_Red_No_3	0.0
snomed:Ureteric	nci:Ureter	0.46
snomed:Buserelin	nci:Buserelin	0.53
snomed:International_units_per_square_meter	nci:International_Unit_per_Square_Meter	0.64
snomed:Body_fluid	nci:Body_Fluid_or_Substance	0.53
snomed:Sardine	nci:Sardine	0.55
snomed:pN_category	nci:Regional_Lymph_Node_Involvement	0.0
snomed:Body_region_structure	nci:Body_Region	0.41
snomed:Drug_suspension	nci:Mixture	0.14
snomed:Sea_blue_histiocyte	nci:Sea-Blue_Histiocyte	0.6
snomed:Inhaling	nci:Inhaling	0.5
snomed:Recombinant_human_chorionic_gonadotrophin	nci:Human_Chorionic_Gonadotropin	0.36
snomed:Endoscopic_operation	nci:Endoscopic_Surgery	0.27
snomed:Gray_color	nci:Gray_Color	0.5
snomed:Mucopolysaccharide	nci:Glycosaminoglycan	0.08
snomed:Resident_tissue_macrophage	nci:Histiocyte	0.09
snomed:Lymphangiography_NOS	nci:Lymphangiogram	0.42
snomed:Attribute	nci:Concept_Attribute	0.5
snomed:Alkaloid	nci:Alkaloid	0.53
snomed:Reed_Sternberg_cell	nci:Reed-Sternberg_Cell	0.56
snomed:Relative	nci:Relative	0.74
snomed:Arsenic_product	nci:Arsenic	0.4
snomed:Pulse_function	nci:Pulse_Phenomenon	0.37
snomed:Gonadotrophic_hormone	nci:Gonadotropin	0.35
snomed:Nicotine_dependence	nci:Nicotine_Dependence	0.61
snomed:Blood_pressure_finding	nci:Blood_Pressure_Finding	0.59
snomed:Metalloproteinase	nci:Metalloproteinase	0.56
snomed:Collagen_fiber	nci:Collagen_Fiber	0.54
snomed:farad	nci:F	0.0
snomed:Compound_nevus	nci:Compound_Nevus	0.69
snomed:Antineoplastic_chemotherapy_regimen	nci:Chemotherapy_Regimen	0.37
snomed:Child_of	nci:Child_Offspring	0.45
snomed:Physical_examination_procedure	nci:Physical_Examination	0.57
snomed:Techniques_values	nci:Method	0.0
snomed:Hypoxia	nci:Hypoxic	0.44
snomed:Sodium_measurement	nci:Sodium	0.36
snomed:Hemolysis	nci:Hemolysis	0.55
snomed:Perineal	nci:Perineum	0.38
snomed:Types	nci:Type	0.47
snomed:Chest_cold	nci:Lower_Respiratory_Tract_Infection	0.16
snomed:Hydrolase	nci:Hydrolase	0.6
snomed:Specimen	nci:Specimen	0.6
snomed:Dairy_foods	nci:Dairy_Product	0.22
snomed:Nuclear_medicine_diagnostic_procedure	nci:Scanning_Procedure_or_Technique	0.0
snomed:Cancer_antigen_125	nci:CA-125_Antigen	0.66
snomed:Neoplasm_metastatic	nci:Secondary_Neoplasm	0.1
snomed:Oral_hygiene_status	nci:Oral_Hygiene	0.44
snomed:Lymphocytic	nci:Lymphocyte	0.44
snomed:Armenia	nci:Arm	0.36
snomed:Neoplastic_disease	nci:Neoplastic_Syndrome	0.27
snomed:Lengths	nci:Length	0.48
snomed:Treats	nci:Intent_To_Treat	0.47
snomed:mIU	nci:Milliinternational_Unit	0.78
snomed:Nicotine	nci:Nicotine	0.52
snomed:Liquid_substance	nci:Liquid	0.4
snomed:Vaginal_structure	nci:Vaginal	0.38
snomed:Object	nci:Object	0.5
snomed:Digit_structure	nci:Digital	0.24
snomed:Physical_examination_procedure	nci:Physical	0.33
snomed:Hematology_test	nci:Hematologic_Technique	0.61
snomed:Quantity	nci:Quantity	0.5
snomed:Assisted_suicide	nci:Terminal_Sedation	0.5
snomed:Mass_of_body_structure	nci:Mass_Property	0.3
snomed:Yeast	nci:Yeast_Dried	0.5
snomed:Marginal	nci:Margin	0.5
snomed:Discharge_of_eye	nci:Eye_Discharge	0.58
snomed:Manual	nci:Manual	0.5
snomed:Donor	nci:Donor_Generic	0.54
snomed:Thoracic_structure	nci:Thoracic	0.39
snomed:Subkingdom_Tracheobionta	nci:Vascular_Plant	0.04
snomed:Small_intestinal_structure	nci:Intestine_Small_Intestine_MMHCC	0.39
snomed:Class	nci:Class_Taxon	0.5
snomed:Hypericum_perforatum	nci:Hypericum_perforatum_Plant	0.58
snomed:Tissue_donor	nci:Donor_Generic	0.31
snomed:Squamous_cell_carcinoma_metastatic	nci:Metastatic_Squamous_Cell_Carcinoma	0.65
snomed:Ulceration	nci:Ulceration	0.5
snomed:nkat	nci:Nanokatal	0.65
snomed:Drug_abuse	nci:Drug_Abuse	0.52
snomed:Structure_of_root_canal_of_tooth	nci:Canalis_Radicis_Dentis	0.03
snomed:Chemical_element	nci:Element_Part	0.32
snomed:degrees_C	nci:Degree_Celsius	0.51
snomed:Probe_device	nci:Probe	0.39
snomed:Chemotherapy	nci:Chemotherapy_Regimen_New	0.43
snomed:Bone_marrow_aspiration_procedure	nci:Bone_Marrow_Aspiration	0.63
snomed:Somatomedin_preparation	nci:Insulin-Like_Growth_Factor	0.4
snomed:Never_smoked_tobacco	nci:Never_Smoker	0.43
snomed:Colony_stimulating_factor_granulocytic	nci:Recombinant_Granulocyte_Colony_Stimulating_Factor	0.65
snomed:Radical	nci:Radical	0.54
snomed:Immunologic_competence_function	nci:Immunocompetence	0.41
snomed:Techniques_values	nci:Techniques	0.44
snomed:ms	nci:Ms	0.0
snomed:Date	nci:Date	0.5
snomed:Alphanumeric_entity	nci:Alphanumeric	0.45
snomed:Lupus_erythematosus_cell	nci:LE_Cell	0.5
snomed:Implant_device	nci:Implant	0.44
snomed:Instrument_device	nci:Instrumentation	0.43
snomed:cpm	nci:Count_per_Minute	0.59
snomed:Monocyte_count_NOS	nci:Mono	0.32
snomed:Corneal_disorder_NOS	nci:Cornea	0.35
snomed:Suspension	nci:Suspension	0.62
snomed:Secondary_Ca_NOS	nci:Secondary_Neoplasm	0.36
snomed:Gonadorelin	nci:Gonadotrophin_Releasing_Hormone	0.59
snomed:In_situ_perfusion	nci:Isolated_Perfusion	0.35
snomed:Squamous_cell_atypia	nci:Squamous_Cell_Atypia	0.65
snomed:Aspiration	nci:Aspiration	0.6
snomed:Thyrotropin_releasing_factor_agent	nci:Thyrotropin-Releasing_Hormone	0.39
snomed:Austria	nci:At	0.0
snomed:Sexual_transmission	nci:Sexual_Transmission	0.5
snomed:Sensitization	nci:Sensitization	0.5
snomed:Erythropoietin	nci:Erythropoietin	0.51
snomed:Person_in_the_family	nci:Family_Member	0.27
snomed:Motor_behavior	nci:Physical_Activity	0.08
snomed:Intra_arterial_injection	nci:Intraarterial_Route_of_Drug_Administration	0.54
snomed:Fluctuating	nci:Fluctuation	0.5
snomed:Goiter	nci:Goiter	0.75
snomed:Cone	nci:Cone_Dosage_Form	0.63
snomed:Operative_procedure_on_digestive_system	nci:Digestive_System_Surgery	0.54
snomed:Cardiovascular_finding	nci:Cardiovascular_Manifestation	0.31
snomed:Retroperitoneal_structure	nci:Retroperitoneal	0.43
snomed:Platelet_count_NOS	nci:Platelet	0.5
snomed:Abnormal_red_blood_cell	nci:Abnormal_Red_Blood_Cell	0.6
snomed:Cone_of_retina	nci:Cone_Shape	0.35
snomed:Genetic_inversion	nci:Chromosomal_Inversion	0.36
snomed:Poisoning	nci:Poisoning	0.51
snomed:Human_menopausal_gonadotropin	nci:Therapeutic_Human_Menopausal_Gonadotropin	0.55
snomed:Pediatric_surgery	nci:Pediatric_Surgery	0.59
snomed:Pulse_rate	nci:Pulse_Rate	0.54
snomed:Hormone	nci:Hormone	0.63
snomed:Transplant	nci:Graft	0.54
snomed:Behavior_showing_reduced_motor_activity	nci:Reduced_Activity	0.3
snomed:Leuprolide_acetate	nci:Leuprolide	0.53
snomed:Immunomodulator	nci:Immunostimulant	0.32
snomed:Nuclear_medicine_diagnostic_procedure	nci:Radionuclide_Imaging	0.1
snomed:Equal	nci:Equivalent	0.33
snomed:Immunoglobulin_hinge_region	nci:Immunoglobulin_Hinge_Region	0.56
snomed:Nicotine_inhaler	nci:Nicotine_Inhaler	0.5
snomed:Atrial_myxoma_with_lentigines	nci:Carney_Complex	0.58
snomed:Surgical_removal	nci:Excision	0.54
snomed:Heterogeneous_nuclear_RNA	nci:hnRNA	0.5
snomed:Finding_of_head_and_neck_region	nci:Head_and_Neck_Finding	0.43
snomed:Granular_casts	nci:Granular_Cast_Formation	0.49
snomed:Vascular_constriction_function	nci:Vasoconstriction	0.37
snomed:Erythroleukemia_FAB_M6	nci:Pure_Erythroid_Leukemia	0.47
snomed:Primary_malignant_neoplasm_of_liver	nci:Chemotherapy_Regimen_Used_to_Treat_Primary_Malignant_Neoplasm_of_Liver	0.34
snomed:Tonga	nci:To	0.0
snomed:Orthodontic_procedure	nci:Orthodontic_Treatment	0.54
snomed:Emotion	nci:Emotional	0.46
snomed:Monocyte_count	nci:Mono	0.34
snomed:Cytologic_atypia	nci:Cytologic_Atypia	0.73
snomed:Somatomedin	nci:Insulin-Like_Growth_Factor	0.57
snomed:Tumor_associated_antigen	nci:Tumor_Antigen	0.67
snomed:Integumentary_system_finding	nci:Integumentary_System_Finding	0.53
snomed:Low_temperature	nci:Cold_Temperature	0.34
snomed:Chemical_element	nci:Element_or_Isotope	0.6
snomed:Structure_of_cardiovascular_system	nci:Cardiovascular_System	0.42
snomed:Atypical_lymphocyte	nci:Atypical_Lymphocyte	0.5
snomed:Immunologic_function	nci:Immune_Function	0.46
snomed:Hospice	nci:Hospice_Care	0.5
snomed:Niemann_Pick_cell	nci:Niemann-Pick_Cell	0.6
snomed:Wedge	nci:Wedge	0.5
snomed:Neurological_finding	nci:Nervous_System_Finding	0.06
snomed:Cryosurgery	nci:Cryoablation	0.08
snomed:Factor_I	nci:Fibrinogen	0.0
snomed:With_type	nci:Terminology_Kind	0.0
snomed:Human_genome	nci:Human_Genome	0.5
snomed:Prolactin_preparation	nci:Prolactin	0.53
snomed:Damage	nci:Tissue_Damage	0.42
snomed:Impaired_tissue_repair	nci:Impaired_Healing	0.18
snomed:Liquid_dose_form	nci:Liquid_Dosage_Form	0.52
snomed:Spinal_cord_meninges_structure	nci:Spinal_Meninges	0.45
snomed:Silybum_marianum	nci:Milk_Thistle	0.0
snomed:Autoimmune_reaction	nci:Autoimmune	0.41
snomed:Fish	nci:Fish_Vertebrates	0.51
snomed:Proliferation	nci:Proliferation	0.5
snomed:Stomach_structure	nci:Gastric	0.0
snomed:Thymosin	nci:Thymosin	0.5
snomed:White_fish	nci:White_Fish	0.51
snomed:mkat	nci:Millikatal	0.65
snomed:Immunomodulator	nci:Immunoadjuvant	0.18
snomed:Dietary_finding	nci:Diet	0.43
snomed:Discontinued	nci:Disc	0.35
snomed:Thrombopoietin	nci:Recombinant_Human_Thrombopoietin	0.38
snomed:Carcinogen_effect_in_offspring	nci:Carcinogen_Effect_in_Offspring	0.5
snomed:Ringed_sideroblast	nci:Ringed_Sideroblast	0.5
snomed:Messenger_RNA	nci:Messenger_RNA	0.5
snomed:Carbon_dioxide_measurement	nci:Carbon_Dioxide	0.41
snomed:Lymphangiogram	nci:Lymphography	0.45
snomed:Fibrinogen_assay	nci:Fibrinogen	0.44
snomed:Pathology	nci:Pathology	0.59
snomed:pkat	nci:Picokatal	0.65
snomed:Autoimmune	nci:Autoimmune	0.6
snomed:Scale_device	nci:Scale	0.39
snomed:Grades	nci:Histopathologic_Grade	0.47
snomed:watt	nci:Watt	0.72
snomed:Gastrin_releasing_peptide	nci:Gastrin_Releasing_Peptide	0.54
snomed:Genetic_polymorphism	nci:Polymorphism	0.39
snomed:Chronic_obstructive_airways_disease_NOS	nci:Chronic_Obstructive_Airways_Disease	0.67
snomed:Gonadotrophic_hormone	nci:Therapeutic_Gonadotropin	0.67
snomed:Gaucher_cell	nci:Guacher_s_Cell	0.6
snomed:Usage	nci:Use	0.5
snomed:Thoracentesis	nci:Thoracentesis	0.78
snomed:Shape_finding	nci:Shape	0.42
snomed:lux	nci:Lux	0.57
snomed:Magnesium_measurement	nci:Magnesium	0.39
snomed:Breast_milk	nci:Milk	0.32
snomed:Pain	nci:Painful	0.42
snomed:Urethral	nci:Urethra	0.48
snomed:International_normalized_ratio	nci:International_Normalized_Ratio_of_Prothrombin_Time	0.43
snomed:Iraqi	nci:Iraqi	0.56
snomed:Pharmaceutical_excipient	nci:Pharmaceutical_Excipient	0.58
snomed:Postoperative_wound_infection	nci:Surgical_Wound_Infection	0.32
snomed:Transmission	nci:Transmission_Information	0.5
snomed:Angiography	nci:Angiogram	0.42
snomed:Drug_suspension	nci:Suspension_Dosage_Form	0.68
snomed:Nutrients	nci:Nutrient_Property	0.48
snomed:Tonga	nci:Ton	0.41
snomed:Chemical_compound	nci:Chemical	0.4
snomed:Sexual_behavior	nci:Sex_Personal_Attribute	0.27
snomed:Origins	nci:Origin	0.48
snomed:Lymphocyte_antigen_CD117	nci:Stem_Cell_Factor_Receptor	0.19
snomed:Rod_of_retina	nci:Rod_Shape	0.3
snomed:uCi	nci:Microcurie	0.67
snomed:Adenocarcinoma_metastatic	nci:Metastatic_Adenocarcinoma	0.64
snomed:Sarcolemma_structure	nci:Sarcolemma	0.46
snomed:DLethargy	nci:Lethargic	0.36
snomed:Chronic	nci:Chronic	0.53
snomed:Antineoplastic_chemotherapy_regimen	nci:Chemotherapy	0.36
snomed:Genetic_marker_function	nci:Genetic_Marker	0.43
snomed:No	nci:No	0.0
snomed:Date	nci:Date_Value	0.5
snomed:Parathyroid_structure	nci:Parathyroid_Gland	0.57
snomed:Pituitary_luteinizing_hormone	nci:Luteinizing_Hormone	0.49
snomed:Discharge	nci:Discharge_from_Healthcare_Facility	0.5
snomed:Retinal_vascular_disorder	nci:Retinal_Vascular_Disorder	0.61
snomed:Armenians	nci:Armenian	0.54
snomed:Bone_structure_of_spine	nci:Vertebral	0.0
snomed:Anticholinergic_agent	nci:Anticholinergic_Agent	0.66
snomed:Guam	nci:Guam	0.5
snomed:Beta_interferon	nci:Interferon_Beta	0.5
snomed:Megakaryocyte	nci:Megakaryocyte	0.6
snomed:Corneal_abrasion	nci:Corneal_Abrasion	0.63
snomed:Thoracic_structure	nci:Thorax	0.27
snomed:Cannabis_dependence_continuous	nci:Cannabis_Dependence_Continuous_Use	0.69
snomed:Suicide	nci:Suicide	0.5
snomed:Death	nci:Death	0.51
snomed:Pleurodesis	nci:Pleurodesis	0.76
snomed:Primary_malignant_neoplasm_of_liver_NOS	nci:Chemotherapy_Regimen_Used_to_Treat_Primary_Malignant_Neoplasm_of_Liver	0.3
snomed:Incision	nci:Surgical_Incision	0.54
snomed:Ulceration	nci:Ulcer	0.4
snomed:Oregon	nci:Or	0.0
snomed:Structure_resulting_from_tissue_repair_process	nci:Wound_Repair	0.0
snomed:Cannabis_sativa	nci:Marijuana	0.42
snomed:Somatic_mutation	nci:Somatic_Mutation_Abnormality	0.55
snomed:Ear_discharge	nci:Otorrhea	0.12
snomed:Intestinal_structure	nci:Intestinal	0.41
snomed:Gamma_interferon	nci:Interferon_Gamma	0.5
snomed:Echography	nci:Diagnostic_Ultrasound	0.17
snomed:Leukocyte	nci:Leukocyte	0.54
snomed:GD2_ganglioside	nci:Ganglioside_GD2	0.56
snomed:Smoker	nci:Smoker	0.53
snomed:Total_protein_measurement	nci:Protein	0.23
snomed:Melanocytic_nevus	nci:Mole	0.0
snomed:Octreotide_preparation	nci:Octreotide	0.39
snomed:Sexual_activity_NOS	nci:Sex_Personal_Attribute	0.26
snomed:Magnesium	nci:Magnesium	0.5
snomed:Drug_emulsion	nci:Emulsion	0.4
snomed:Pneumocystosis_jiroveci_pneumonia	nci:Pneumocystis_Carinii_Pneumonia	0.48
snomed:Disorder_of_parathyroid_gland	nci:Parathyroid_Gland_Disorder	0.74
snomed:Protein	nci:Protein	0.57
snomed:Route_of_administration_value	nci:Drug_Route_of_Administration	0.73
snomed:Administration_of_antineoplastic_agent	nci:Chemotherapy	0.06
snomed:Nasal_structure	nci:Nasal	0.36
snomed:Fluorescence_in_situ_hybridization	nci:Fluorescence_in_situ_Hybridization	0.66
snomed:Upper_digestive_tract_structure	nci:Upper_Gastrointestinal_Tract	0.31
snomed:Atypical_lymphocyte	nci:Abnormal_Lymphocyte	0.28
snomed:Structure_of_digestive_system	nci:Gastrointestinal_System	0.38
snomed:Glandular_cell_atypia	nci:Glandular_Cell_Atypia	0.62
snomed:Finding_of_tobacco_smoking_behavior	nci:Tobacco_Smoking	0.35
snomed:Pigmented_nevus_no_ICD_O_subtype	nci:Mole	0.0
snomed:Disorder_of_neck	nci:Neck_Disorder	0.5
snomed:Infarct	nci:Infarction	0.45
snomed:Nipple_discharge_NOS	nci:Nipple_Discharge	0.58
snomed:Hypericum_perforatum_extract	nci:Hypericum_Perforatum	0.5
snomed:Behavior_finding	nci:Behavior	0.43
snomed:Sodium_product	nci:Sodium	0.39
snomed:Acanthocyte	nci:Acanthocyte	0.59
snomed:Libido_function	nci:Libido	0.38
snomed:Contraceptive_diaphragm_device	nci:Vaginal_Diaphragm	0.32
snomed:Fraction_of	nci:Fraction	0.47
snomed:Infectious_disease	nci:Infectious_Disorder	0.54
snomed:Pathogeneses	nci:Pathogenesis	0.43
snomed:Posterior	nci:Posterior	0.57
snomed:Pigmented_nevus_no_ICD_O_subtype	nci:Pigmented_Nevus	0.6
snomed:Pus	nci:Pus	0.5
snomed:colony_forming_unit	nci:Colony_Forming_Unit	0.57
snomed:Neoplasm_metastatic	nci:Metastatic_Malignant_Neoplasm	0.51
snomed:Grading	nci:Histopathologic_Grade	0.5
snomed:Over_the_counter_products	nci:Over_the_Counter_Product	0.49
snomed:Mammography	nci:Mammogram	0.42
snomed:Cocaine_drug_dependence_NOS	nci:Cocaine_Dependence	0.64
snomed:Order_Anoplura	nci:Lice	0.05
snomed:Body_tissue_structure	nci:Tissue	0.31
snomed:Cerebrospinal_fluid_leak	nci:Cerebrospinal_Fluid_Leakage	0.48
snomed:Systole_function	nci:Systole	0.39
snomed:Busulfan	nci:Bus_Device	0.34
snomed:Continuous	nci:Continuous	0.5
snomed:Structure_of_cardiovascular_system	nci:Cardiovascular	0.31
snomed:Sexual_excitation_function	nci:Sexual_Arousal	0.09
snomed:Structure_of_vertebra	nci:Vertebral	0.25
snomed:Dopachrome_isomerase	nci:Recombinant_Tyrosinase-Related_Protein-2	0.05
snomed:Vitamin_B12_measurement	nci:Vitamin_B12	0.39
snomed:Behind	nci:Back	0.0
snomed:ENV_gene	nci:ENV	0.5
snomed:Human_chorionic_gonadotropin_beta_subunit	nci:Human_Chorionic_Gonadotropin_Beta_Subunit	0.5
snomed:Discharge_of_eye_NOS	nci:Eye_Discharge	0.61
snomed:Australia	nci:As	0.0
snomed:TAT_gene	nci:TAT_Gene	0.5
snomed:Cardiovascular_system_alteration	nci:Cardiovascular_Alteration	0.47
snomed:Lymphoid_interstitial_pneumonia	nci:Lip	0.0
snomed:Drepanocyte	nci:Sickle_Cell	0.09
snomed:Perineural_route	nci:Perineural_Route_of_Drug_Administration	0.54
snomed:Pituitary_follicle_stimulating_hormone	nci:Folitropin	0.12
snomed:Discharge	nci:Fluid_Discharge	0.56
snomed:Platelet_count_NOS	nci:Platelet_Count	0.84
snomed:Contrast_radiology_of_lymphatic_tissue_NOS	nci:Lymphangiogram	0.0
snomed:Administration_of_antineoplastic_agent	nci:Chemotherapy_Regimen	0.0
snomed:Bean	nci:Bean	0.54
snomed:Aspartate_aminotransferase_measurement	nci:SGOT-AST_Protein	0.04
snomed:Infectious_disease	nci:Infectious_Disease_Pathway	0.51
snomed:Unit_of_biological_and_biochemical_measurement	nci:Biological_Unit	0.55
snomed:Lymphocyte_antigen_CD105	nci:End	0.0
snomed:Abdominal	nci:Abdominal_Cavity	0.43
snomed:Digit_structure	nci:Digit_Number	0.36
snomed:Unit_of_power	nci:Unit_of_Power	0.64
snomed:Arsenic_product	nci:As	0.0
snomed:mV	nci:Millivolt	0.19
snomed:Platelet_derived_growth_factor	nci:Therapeutic_Platlet-Derived_Growth_Factor	0.63
snomed:Peripheral_blood_mononuclear_cell	nci:Peripheral_Blood_Mononuclear_Cell	0.51
snomed:Pentagastrin	nci:Pentagastrin	0.5
snomed:Mass	nci:Mass	0.51
snomed:Amylase_measurement	nci:Amylase	0.37
snomed:Associated_topography	nci:Site	0.0
snomed:Cocaine_dependence_episodic	nci:Cocaine_Dependence_Episodic_Use	0.7
snomed:Structure_of_endocrine_system	nci:Endocrine_System	0.39
snomed:Comoros_islands	nci:Km	0.0
snomed:Stage_level_3	nci:Stage_III	0.51
snomed:Angiogenin	nci:Recombinant_Angiogenin	0.4
snomed:Fractions_of	nci:Fraction	0.45
snomed:Recurrence	nci:Recurrent	0.52
snomed:Follicle_stimulating_hormone_product	nci:Folitropin	0.21
snomed:Smooth_muscle_cell_atypia	nci:Smooth_Muscle_Cell_Atypia	0.56
snomed:Tissue_plasminogen_activator_preparation	nci:Recombinant_Tissue_Plasminogen_Activator	0.34
snomed:Complex	nci:Complex	0.67
snomed:Laboratory_test	nci:Test	0.53
snomed:mCi	nci:Millicurie	0.67
snomed:Bicarbonate	nci:Bicarbonate	0.5
snomed:Yeast_form	nci:Yeast	0.48
snomed:Peptide	nci:Peptide	0.5
snomed:Lumbar_puncture	nci:Lumbar_Puncture	0.77
snomed:Glucagon_product	nci:Therapeutic_Glucagon	0.41
snomed:Human_menopausal_gonadotrophins	nci:Therapeutic_Human_Menopausal_Gonadotropin	0.56
snomed:Branch_of	nci:Branch	0.46
snomed:Lobelia_cardinalis	nci:Lobelia_cardinalis	0.61
snomed:perc_total_hemoglobin	nci:Percent_of_Total_Hemoglobin	0.67
snomed:Disturbance_of_perception_function	nci:Perception_Disturbance	0.4
snomed:Turner_s_syndrome_NOS	nci:Monosomy_X	0.06
snomed:Carbon_dioxide	nci:Carbon_Dioxide	0.5
snomed:Branch_of	nci:Branch_Anatomy	0.46
snomed:Unit_of_area	nci:Unit_of_Area	0.76
snomed:Prion_disease	nci:Spongiform_Encephalopathy	0.21
snomed:Clone	nci:Cell_Clone	0.37
snomed:Malignant_neoplastic_disease	nci:Malignant_Neoplasm	0.49
snomed:Neoplasm_metastatic	nci:Metastatic_Neoplasm	0.6
snomed:Disease	nci:Diseases_and_Disorders	0.52
snomed:Erythroleukemia_FAB_M6	nci:Acute_Erythroid_Leukemia	0.52
snomed:Molecular_conformation	nci:Conformation	0.36
snomed:Discharge_from_eye	nci:Eye_Discharge	0.62
snomed:Elderly_person	nci:Senescence	0.0
snomed:Nutrient_supplementation	nci:Nutritional_Supplement	0.52
snomed:Enzyme_inhibitor_protein	nci:Enzyme_Inhibitor_Protein	0.62
snomed:Face_structure	nci:Face	0.35
snomed:Osteotomy	nci:Osteotomy	0.54
snomed:Chemotherapy	nci:Chemotherapy_Regimen	0.43
snomed:Unit_dose	nci:Unit_Dose	0.5
snomed:Lymphomatous_meningitis	nci:Metastasis_to_the_Leptomeninges	0.22
snomed:Plasmid	nci:Plasmid	0.5
snomed:Death_by_electrocution	nci:Electrocution	0.39
snomed:Adhesion	nci:Tissue_Adhesion	0.5
snomed:Tissue_specimen	nci:Tissue_Sample	0.25
snomed:Classes	nci:Class_Taxon	0.45
snomed:Plain_film	nci:Radiograph	0.0
snomed:kIU	nci:Kallikrein_Inhibitor_Unit	0.74
snomed:Child	nci:Child_Offspring	0.64
snomed:Implantation	nci:Implantation	0.5
snomed:Corticotropin_preparation	nci:Adrenocorticotropic_Hormone	0.52
snomed:Dietary_history	nci:Dietary_History	0.5
snomed:Thyrotropin_releasing_factor	nci:Thyrotropin-Releasing_Hormone	0.42
snomed:Pediatric_surgery	nci:Pediatric_Surgical_Procedures	0.59
snomed:Superficial_injury_of_cornea_NOS	nci:Superficial_Injury_of_Cornea	0.66
snomed:Colony_stimulating_factor_preparation	nci:Colony_Stimulating_Factor	0.48
snomed:Immune_response_function	nci:Immune_Response	0.44
snomed:Long	nci:Long	0.5
snomed:Drug_interaction	nci:Interaction	0.42
snomed:Gonadorelin	nci:Therapeutic_Gonadorelin	0.59
snomed:Prolactin	nci:Prolactin	0.61
snomed:Tumor_stage	nci:Stage	0.5
snomed:Manipulation	nci:Manipulation	0.5
snomed:Atypical_lymphocyte	nci:Reactive_Lymphocyte	0.17
snomed:Stage	nci:Stage_Generic	0.5
snomed:Cancer_antigen_15_3	nci:MUC-1_Antigen	0.61
snomed:Developmental_anomaly	nci:Congenital_Abnormality	0.18
snomed:nCi	nci:Nanocurie	0.68
snomed:Castor_bean	nci:Ricinus_communis	0.5
snomed:Structure_of_immune_system	nci:Immune_System	0.37
snomed:Somatostatin_preparation	nci:Growth_Hormone_Release_Inhibiting_Factor	0.41
snomed:Acute_myeloid_leukemia_M6_type	nci:Erythroleukemia	0.22
snomed:Nasal	nci:Nose	0.0
snomed:Kingdom_Animalia	nci:Animal	0.29
snomed:Lymphokine	nci:Lymphokine	0.5
snomed:Pleural_cavity_obliteration	nci:Pleurodesis	0.31
snomed:Third	nci:Third_Name_Suffix	0.5
snomed:Congenital_disorder_due_to_abnormality_of_chromosome_number_OR_structure	nci:Chromosome_Disorder	0.34
snomed:Gonadorelin_acetate	nci:Gonadorelin_Acetate	0.55
snomed:Immunoglobulin_products	nci:Immunoglobulin	0.43
snomed:Huntington_s_chorea	nci:Huntingtons_Disease_Pathway	0.29
snomed:Drug_therapy	nci:Treatment_With_Medication	0.0
snomed:Peptide_hydrolase_inhibitor	nci:Protease_Inhibitor	0.31
snomed:Atypical_mononuclear_cell	nci:Atypical_Mononuclear_Cell	0.5
snomed:Psychoactive_substance_dependence	nci:Drug_Dependence	0.15
snomed:Neoplasm	nci:Neoplasm	0.59
snomed:Keratoplasty	nci:Corneal_Transplant	0.0
snomed:Leptomeninges_structure	nci:Leptomeninges	0.49
snomed:Antibody_binding_site	nci:Antibody_Binding_Site	0.5
snomed:Excision_biopsy	nci:Excisional_Biopsy	0.65
snomed:Belgium	nci:Bel	0.36
snomed:Local	nci:Regional	0.06
snomed:Gonadotropin_releasing_factor	nci:Therapeutic_Gonadorelin	0.33
snomed:Endoscopic_procedure	nci:Endoscopic_Surgery	0.26
snomed:Nipple_discharge_symptom	nci:Nipple_Discharge	0.55
snomed:Surgical_procedure	nci:Surgery	0.13
snomed:Psychometric_testing	nci:Psychometrics	0.45
snomed:Malignant_tumor_of_vault_of_bladder	nci:Dome_of_the_Bladder	0.09
snomed:Diagnostic_ultrasonography	nci:Ultrasound	0.08
snomed:Lymphocyte	nci:Lymphocytic	0.44
snomed:Surgery	nci:Surgical	0.24
snomed:Diagnostic_ultrasonography	nci:Ultrasonogram	0.29
snomed:Serum_total_cholesterol_measurement	nci:Cholesterol	0.26
snomed:Spherocyte	nci:Spherocyte	0.59
snomed:Soft_tissues	nci:Soft_Tissue	0.55
snomed:Breast_milk	nci:Breast_Milk	0.57
snomed:Second	nci:Second_Name_Suffix	0.5
snomed:Ribosomal_RNA	nci:Ribosomal_RNA	0.5
snomed:Nucleic_acid	nci:Nucleic_Acids	0.55
snomed:Abdominal_cavity_structure	nci:Abdominal_Cavity	0.45
snomed:X_ray_thoracic_cage_NOS	nci:Chest_Radiography	0.24
snomed:Carcinoembryonic_antigen	nci:Carcinoembryonic_Antigen	0.54
snomed:Therapeutic_aspiration_procedure_NOS	nci:Therapeutic_Aspiration	0.61
snomed:Hematopoietic_system_structure	nci:Hematopoietic_System	0.45
snomed:DOld_age	nci:Senescence	0.0
snomed:Pathogenesis	nci:Pathogenesis	0.5
snomed:Gastrostomy	nci:Gastrostomy	0.65
snomed:Nuclear_medicine_diagnostic_procedure	nci:Radionuclide_Scanning	0.0
snomed:Leuprorelin	nci:Leuprolide_Base	0.53
snomed:Atypical_lymphoblast	nci:Atypical_Lymphoblast	0.5
snomed:Retinal_disorder	nci:Retinopathy	0.16
snomed:Structure_of_genitourinary_system	nci:Genitourinary	0.3
snomed:RET_proto_oncogene	nci:RET_Gene	0.44
snomed:Lactate_dehydrogenase_measurement	nci:Lactate_Dehydrogenase	0.44
snomed:Lymphocyte_antigen_CD117	nci:Kit	0.0
snomed:Hormone	nci:Therapeutic_Hormone	0.59
snomed:Follicle_stimulating_hormone_product	nci:Follicle_Stimulating_Hormone	0.47
snomed:No	nci:N	0.0
snomed:Meckel_s_diverticulum	nci:Meckel_Diverticulum	0.52
snomed:Colorectal_surgery	nci:Colon_and_Rectal_Surgery	0.53
snomed:Disorder_of_skin	nci:Skin_Disorder	0.5
snomed:Primary_malignant_neoplasm_of_liver_NOS	nci:Primary_Malignant_Neoplasm_of_Liver	0.55
snomed:Mean_blood_pressure	nci:Map	0.0
snomed:Finding_of_urinary_tract_proper	nci:Urinary_Tract_Finding	0.44
snomed:Benign_neoplasm_of_stomach	nci:Benign_Mouse_Gastric_Neoplasm	0.36
snomed:Nicotine_nasal_spray	nci:Nicotine_Nasal_Spray	0.52
snomed:Hallucinogen_dependence_NOS	nci:Hallucinogen_Dependence	0.68
snomed:Intramuscular_injection	nci:Intramuscular_Injection	0.52
snomed:Therapeutic_procedure	nci:Therapeutic_Procedure	0.55
snomed:Glucagon_product	nci:Glucagon	0.41
snomed:Acute_lymphoid_leukemia_disease	nci:All	0.0
snomed:Intralesional_route	nci:Intralesional	0.58
snomed:Canada	nci:Can	0.38
snomed:Centesis	nci:Paracentesis	0.55
snomed:Expiration	nci:Expiration	0.5
snomed:Activity	nci:Activity	0.54
snomed:Indirect	nci:Indirect	0.61
snomed:Problem	nci:Problem	0.5
snomed:Diaphragmatic	nci:Diaphragm	0.45
snomed:Abrasion	nci:Abrasion	0.53
snomed:Inguinal	nci:Inguinal_Region	0.5
snomed:Cigar_smoker	nci:Cigar_Smoking	0.45
snomed:Cosyntropin_preparation	nci:Cortrsyn	0.4
snomed:Adrenocorticotropic_hormone	nci:Adrenocorticotropic_Hormone	0.55
snomed:Computerized_axial_tomography	nci:Cat	0.0
snomed:Secondary_Ca_NOS	nci:Metastatic_Malignant_Neoplasm	0.04
snomed:Immune_enhancement_agent	nci:Immunoadjuvant	0.12
snomed:Laboratory_procedure	nci:Test_Generic	0.0
snomed:Defect	nci:Defect	0.5
snomed:Application	nci:Application_Form	0.62
snomed:Calcium_measurement	nci:Calcium	0.37
snomed:Macrocytic_erythrocyte	nci:Macrocyte	0.4
snomed:Exhaling	nci:Expiration	0.0
snomed:Ingestion	nci:Ingestion	0.5
snomed:Patient_died	nci:Death_Adverse_Event_Not_Associated_with_More_Specific_CTCAE_Term_NOS	0.04
snomed:Propionibacterium_granulosum	nci:Corynebacterium_Granulosum	0.32
snomed:Female_genital	nci:Female_Genitalia	0.48
snomed:Mismatched_blood_transfused	nci:Incompatible_Blood_Transfusion	0.1
snomed:Diagnostic_nuclear_medicine_NOS	nci:Radionuclide_Imaging	0.05
snomed:Insulin_product	nci:Insulin	0.4
snomed:Behind	nci:Dorsal	0.1
snomed:Atypical_squamous_cells_of_undetermined_significance	nci:Atypical_Squamous_Cell_of_Undetermined_Significance	0.61
snomed:Finding_relating_to_sexuality_and_sexual_activity	nci:Sex	0.07
snomed:Gene_deletion	nci:Gene_Deletion	0.5
snomed:Degenerative_abnormality	nci:Degenerative_Disorder	0.27
snomed:Precursor_B_cell_neoplasm	nci:Precursor_B_Cell_Neoplasm_of_the_Mouse_Hematologic_System	0.64
snomed:Becaplermin	nci:Therapeutic_Platelet_Derived_Growth_Factor_Beta_Chain	0.62
snomed:Insulin	nci:Regular_Insulin	0.48
snomed:Bile_salt	nci:Bile_Salt	0.5
snomed:Malignant_tumor_of_ureteric_orifice	nci:Ureteric_Orifice	0.33
snomed:Origins	nci:Begin	0.13
snomed:Hydrocarbon	nci:Hydrocarbon	0.54
snomed:Posterior	nci:Dorsal	0.07
snomed:Disorder_of_cornea	nci:Eye_Cornea_MMHCC	0.27
snomed:Fluorescence_in_situ_hybridization	nci:Fish	0.0
snomed:Intestinal	nci:Intestinal	0.56
snomed:Neuronevus	nci:Neuronevus	0.68
snomed:Clinical_finding	nci:Finding_Generic	0.32
snomed:Blackberries	nci:BlackBerry_Device	0.43
snomed:Skin_pigmentation_function	nci:Skin_Pigmentation	0.44
snomed:Retinol_equivalents	nci:Retinol_Equivalent	0.59
snomed:Anthraquinone	nci:Anthraquinone_Compound	0.52
snomed:Plasmacytoid_cell	nci:Lymphoplasmacytoid_Cell	0.42
snomed:Nuclear_medicine_imaging_procedure	nci:Radionuclide_Scanning	0.0
snomed:Disorder_of_cardiovascular_system	nci:Cardiovascular_Disorder	0.52
snomed:Drug_or_medicament	nci:Medicine	0.07
snomed:Substance	nci:Substance	0.52
snomed:Peritoneal_fluid	nci:Peritoneal_Effusion	0.29
snomed:Diastole_function	nci:Diastole	0.4
snomed:Male_genital	nci:Male_Genital_Organ	0.44
snomed:Cod_liver_oil	nci:Cod_Liver_Oil	0.5
snomed:Event	nci:Event	0.5
snomed:Hypericum_perforatum_extract	nci:Hypericum_perforatum_Plant	0.54
snomed:Senile_corneal_changes_NOS	nci:Senile_Corneal_Change	0.47
snomed:Myelogram	nci:Myelogram	0.5
snomed:Thyroid_preparation	nci:Thyroid_Agent	0.53
snomed:Immunophenotyping	nci:Immunophenotype	0.45
snomed:Corneal_stromal_edema	nci:Stromal_Corneal_Edema	0.63
snomed:Dissection_procedure	nci:Tissue_Dissection	0.41
snomed:Drug_interaction	nci:Drug_Interaction	0.5
snomed:Green_color	nci:Green	0.45
snomed:Oprelvekin	nci:Therapeutic_Interleukin-11	0.72
snomed:Hypochromic_erythrocyte	nci:Hypochromic_Red_Blood_Cell	0.29
snomed:Treats	nci:Treat	0.47
snomed:Hypokinetic	nci:Reduced_Activity	0.11
snomed:Keloid	nci:Keloid	0.5
snomed:Octreotide_acetate	nci:Octreotide_Acetate	0.5
snomed:Mean_blood_pressure	nci:Mean_Arterial_Pressure	0.41
snomed:Arsenic	nci:As	0.0
snomed:Beef	nci:Beef	0.52
snomed:Immunoglobulin_constant_region	nci:Immunoglobulin_Constant_Region	0.56
snomed:Coagulation_factor_I	nci:Fibrinogen	0.0
snomed:Digestive_system_function	nci:Digestion	0.37
snomed:Intermittent	nci:Intermittent	0.5
snomed:Nuclear_medicine_imaging_procedure	nci:Scan	0.0
snomed:Secondary_malignant_neoplastic_disease	nci:Secondary_Neoplasm	0.59
snomed:Chloride_measurement	nci:Chlorine_Minus_1_Charge	0.38
snomed:Rank	nci:Rank	0.5
snomed:Body_structure	nci:Body	0.36
snomed:Upper_respiratory_infection	nci:Upper_Respiratory_Tract_Infection	0.53
snomed:Double	nci:Double_Qualifier	0.67
snomed:Immunoglobulin_structure	nci:Immunoglobulin	0.5
snomed:Decalcified_structure	nci:Decalcification	0.23
snomed:Nitrogen_compound	nci:Nitrogen_Compound	0.52
snomed:Tuna_fish	nci:Tuna	0.45
snomed:Water	nci:Nutrition_Water	0.26
snomed:Antineoplastic_agent	nci:Antineoplastic_Agent	0.55
snomed:Postoperative_wound_infection_unspecified	nci:Postoperative_Wound_Infection	0.5
snomed:Secondary_malignant_neoplastic_disease	nci:Metastatic_Malignant_Neoplasm	0.32
snomed:Secondary_malignant_neoplasm_of_cervix_uteri	nci:Metastatic_Malignant_Neoplasm_to_the_Cervix	0.27
snomed:Abdominal_structure	nci:Abdominal	0.4
snomed:Injection	nci:Injection_Dosage_Form	0.5
snomed:Antibody_titer_measurement	nci:Antibody_Titer	0.41
snomed:Atrial_myxoma_with_lentigines	nci:Name_Generic_Concept	0.0
snomed:Albumin	nci:Albumin	0.5
snomed:Hairy_cell	nci:Hairy_Cell	0.58
snomed:Uncertain	nci:Uncertainty	0.47
snomed:Atrial_structure	nci:Atrial	0.37
snomed:Water	nci:Water	0.5
snomed:Anergy	nci:Anergy	0.5
snomed:Suppurative_inflammation	nci:Suppuration	0.32
snomed:Diagnostic_amniocentesis	nci:Amniocentesis	0.66
snomed:Germans	nci:German	0.53
snomed:Old_age	nci:Senescence	0.04
snomed:Following	nci:Next	0.5
snomed:Transdermal_patch	nci:Skin_Patches	0.04
snomed:Fluoroscopic_retrograde_pyelography	nci:Retrograde_Pyelogram	0.33
snomed:Transmission	nci:Transmission	0.5
snomed:Secondary_malignant_neoplastic_disease	nci:Metastasize	0.0
snomed:Clear_cell_adenocarcinoma	nci:Adenocarcinoma_Clear_Cell	0.52
snomed:Platelet_count	nci:Platelet	0.5
snomed:Process	nci:Process	0.5
snomed:Technique	nci:Method	0.0
snomed:Oral_cavity_structure	nci:Oral	0.3
snomed:Respiratory_function	nci:Respiration	0.42
snomed:Discharge_specimen	nci:Discharge	0.41
snomed:Radioisotope_study_of_liver	nci:Liver_Scan	0.0
snomed:Systemic	nci:Systemic	0.66
snomed:Finding_of_eosinophil_count	nci:Eosinophil_Count	0.43
snomed:Blood_pressure	nci:Blood_Pressure	0.75
snomed:Effusion	nci:Effusion	0.5
snomed:Concentration_function	nci:Concentration	0.43
snomed:Platelet_factor_4	nci:Therapeutic_Platelet_Factor_4	0.59
snomed:Lymphocyte_antigen_CD10	nci:Membrane_Metalloendopeptidase	0.16
snomed:Gonadorelin_agent	nci:Therapeutic_Gonadorelin	0.52
snomed:Trapezoid_bone_structure	nci:Trapezoid	0.37
snomed:Congenital_malformation	nci:Congenital_Abnormality	0.55
snomed:Environment	nci:Environment	0.5
snomed:Disorder_of_blood_vessel	nci:Vascular_Disorder	0.14
snomed:Oprelvekin	nci:Interleukin-11	0.14
snomed:Melanocytic_nevus	nci:Melanocytic_Nevus	0.74
snomed:Kallikrein_inhibitory_unit_per_milliliter	nci:Kallikrein_Inactivator_Unit_per_Milliliter	0.67
snomed:Immunosuppression	nci:Immunosuppressive_Effect	0.46
snomed:Visual_function	nci:Sight	0.0
snomed:Origin	nci:Origin	0.5
snomed:Relationships	nci:Relationship	0.49
snomed:Interval	nci:Window	0.0
snomed:Structural_protein	nci:Structural_Protein	0.66
snomed:Magnesium_measurement	nci:Magnesium_Measurement	0.57
snomed:Glucagon	nci:Therapeutic_Glucagon	0.53
snomed:international_units_per_gram	nci:International_Unit_per_Gram	0.63
snomed:Human_calcitonin	nci:Calcitonin	0.43
snomed:Gaseous_substance	nci:Gas	0.27
snomed:Fat_laden_macrophage	nci:Lipid-Laden_Macrophage	0.43
snomed:Gonadotropin_releasing_factor	nci:Gonadotrophin_Releasing_Hormone	0.46
snomed:Administration	nci:Treatment	0.0
snomed:Dysplastic_nevus	nci:Dysplastic_Nevus	0.67
snomed:Surgical_margins	nci:Margin	0.29
snomed:Pituitary_hormone	nci:Pituitary_Hormone	0.63
snomed:Interferon_gamma	nci:Interferon_Gamma	0.64
snomed:Foam_cell	nci:Foam_Cell	0.57
snomed:Structure_of_posterior_inferior_cerebellar_artery	nci:Pica	0.0
snomed:Implantation	nci:Drug_Administration_via_Implantation	0.29
snomed:Neck_structure	nci:Neck	0.36
snomed:Degenerative_abnormality	nci:Tissue_Degeneration	0.1
snomed:Sebum	nci:Sebum_MMHCC	0.56
snomed:Senile_corneal_changes	nci:Senile_Corneal_Change	0.49
snomed:Sargramostim	nci:Sargramostim	0.7
snomed:Colony_stimulating_factor_granulocyte_macrophage	nci:Colony_Stimulating_Factor-2	0.55
snomed:Gingival_structure	nci:Gingival	0.39
snomed:Phytochemical	nci:Phytochemical	0.5
snomed:Alteplase	nci:Tissue_Plasminogen_Activator	0.58
snomed:Organic_compound	nci:Organic_Chemical	0.34
snomed:Heterocyclic_compound	nci:Heterocyclic_Compound	0.53
snomed:Cardiovascular_agent	nci:Cardioprotective_Agent	0.56
snomed:Secondary_Ca_NOS	nci:Metastatic_Neoplasm	0.03
snomed:MBq	nci:Megabecquerel	0.68
snomed:Prostatic	nci:Prostate_Gland	0.43
snomed:Blue_color	nci:Blue	0.43
snomed:Superficial_injury_of_cornea	nci:Superficial_Injury_of_Cornea	0.63
snomed:Axillary	nci:Axillary	0.57
snomed:Unit_of_energy	nci:Unit_of_Energy	0.67
snomed:Focal	nci:Focus	0.5
snomed:Chronic_rejection_of_renal_transplant	nci:Can	0.0
snomed:Stage	nci:Stage	0.5
snomed:Amniocentesis	nci:Amniocentesis	0.69
snomed:Drug_suspension	nci:Suspension_Action	0.42
snomed:Human_menopausal_gonadotropin	nci:Human_Menopausal_Gonadotropin	0.55
snomed:Disorder_of_intestine	nci:Non-Neoplastic_Intestinal_Disorder	0.35
snomed:Stoma	nci:Stoma	0.5
snomed:Sex_structure	nci:Sex_Personal_Attribute	0.29
snomed:Interval	nci:Window_Interval	0.63
snomed:Plasmablast	nci:Plasmablast	0.5
snomed:Sexual_activity_NOS	nci:Sex	0.26
snomed:Aromatic_hydrocarbon	nci:Aromatic_Hydrocarbon	0.56
snomed:Scrotal	nci:Scrotum	0.36
snomed:Phase	nci:Stage	0.0
snomed:Somatotropin_preparation	nci:Therapeutic_Growth_Hormone	0.42
snomed:Bilirubin_total_measurement	nci:Bilirubin	0.36
snomed:Genetic_polymorphism	nci:Genetic_Polymorphism	0.53
snomed:Oxytocin	nci:Therapeutic_Oxytocin	0.53
snomed:Antibody	nci:Antibody	0.56
snomed:Angiography	nci:Angiography	0.56
snomed:Prion_disease	nci:Prion_Disease_Pathway	0.54
snomed:Nephrotomogram	nci:Nephrotomogram	0.5
snomed:Immunoglobulin_isotype	nci:Antibody_Isotype	0.5
snomed:Syrians	nci:Syrian	0.53
snomed:MV	nci:Millivolt	0.19
snomed:Unit	nci:c_Unit	0.5
snomed:With_staging	nci:Staging	0.39
snomed:Drug_interaction_with_drug	nci:Interaction	0.32
snomed:Orange_flavor	nci:Orange_Fruit	0.4
snomed:Plasminogen_activator	nci:Plasminogen_Activator	0.56
snomed:Female_structure	nci:Female_Gender	0.37
snomed:Nutrients	nci:c_Nutrient	0.48
snomed:Ulcerative	nci:Ulcer	0.4
snomed:Mechanisms	nci:Mechanism	0.48
snomed:Oxidoreductase	nci:Oxidoreductase	0.6
snomed:Glomus_cell	nci:Glomus_Cell	0.5
snomed:Glycoprotein	nci:Glycoprotein	0.54
snomed:Somatomedin_A	nci:Insulin-Like_Growth_Factor-2	0.56
snomed:Tumor_cells_malignant	nci:Malignant_Cell	0.41
snomed:Somatomedin_C	nci:Insulin-Like_Growth_Factor-1	0.55
snomed:Therapeutic_procedure	nci:Treatment_Study	0.0
snomed:Functional_disorder	nci:Dysfunction	0.19
snomed:Grade	nci:Grade	0.5
snomed:Hemosiderin_laden_macrophage	nci:Hemosiderin-Laden_Macrophage	0.5
snomed:Structure_of_axillary_fossa	nci:Axilla	0.27
snomed:Everolimus	nci:Rad	0.0
snomed:Endopeptidase	nci:Protease	0.49
snomed:Tissue_plasminogen_activator	nci:Recombinant_Tissue_Plasminogen_Activator	0.44
snomed:Platelet_aggregation_function	nci:Platelet_Aggregation	0.45
snomed:Small_intestinal	nci:Intestine_Small_Intestine_MMHCC	0.51
snomed:Sarcoma_of_liver	nci:Hepatic_Sarcoma	0.67
snomed:Isolated_limb_perfusion	nci:Limb_Perfusion	0.71
snomed:Male_mammary_gland_structure	nci:Male_Breast	0.05
snomed:Female_structure	nci:Female	0.37
snomed:Heart_structure	nci:Cardiac	0.0
snomed:Inflammation	nci:Inflammation	0.51
snomed:Sexual_activity	nci:Sex_Behavior	0.38
snomed:Ophthalmic_solution	nci:Ophthalmic_Solution	0.5
snomed:Potassium_measurement	nci:Potassium	0.39
snomed:Octreotide	nci:Octreotide	0.5
snomed:Nutrient_supplementation	nci:Supplement_Document	0.3
snomed:Amniotic_cavity_infection_NOS	nci:Amnionitis	0.18
snomed:Undifferentiated_sarcoma	nci:Undifferentiated_Embryonal_Sarcoma	0.6
snomed:Cell_structure	nci:Cell_Space	0.34
snomed:Plug	nci:Plug	0.5
snomed:Guam	nci:Gum	0.0
snomed:farad	nci:Farad	0.7
snomed:Dietary_history_NOS	nci:Dietary_History	0.47
snomed:Metabolic_pathway_function	nci:Metabolic_Pathways	0.44
snomed:Alteplase	nci:Recombinant_Tissue_Plasminogen_Activator	0.56
snomed:Finding_relating_to_sexuality_and_sexual_activity	nci:Sex_Behavior	0.12
snomed:Echography	nci:Ultrasonogram	0.06
snomed:Discharge	nci:Discharge	0.56
snomed:Intramuscular_injection	nci:Intramuscular	0.44
snomed:United_Arab_Emirates	nci:Are	0.0
snomed:Hematopoietic_system_finding	nci:Hematopoietic_System_Finding	0.53
snomed:Body_cavity_structure	nci:Cavity	0.52
snomed:Sexual_activity	nci:Sex	0.27
snomed:Family_history_of_clinical_finding	nci:Family_Medical_History	0.42
snomed:Cannabis_sativa	nci:Cannabis_sativa_L	0.52
snomed:Endocardial	nci:Endocardium	0.5
snomed:Electromechanical_dissociation	nci:Pea	0.0
snomed:Movement	nci:Movement	0.5
snomed:Jejunal	nci:Jejunum	0.36
snomed:Ex_smoker	nci:Former_Smoker	0.25
snomed:DSymptoms	nci:Symptom	0.48
snomed:Finding_of_wound_healing	nci:Wound_Repair	0.36
snomed:Same	nci:Same	0.61
snomed:Immunoglobulin_Fc_fragment	nci:Immunoglobulin_Fc	0.5
snomed:Window	nci:Window_Interval	0.5
snomed:Joint_structure	nci:Articulation	0.0
snomed:English	nci:English	0.56
snomed:Fish	nci:Fish	0.51
snomed:Nutritional_supplement	nci:Supplement	0.32
snomed:Drug_solution	nci:Solution	0.4
snomed:Stage_level_4	nci:Stage_IV	0.39
snomed:Diagnosis	nci:Diagnostic	0.38
snomed:Mix	nci:Mix	0.5
snomed:Bone_resorption_inhibitor	nci:Bone_Resorption_Inhibitor	0.78
snomed:Radiographic_imaging_procedure	nci:X-Ray	0.0
snomed:Pointer	nci:Pointer	0.5
snomed:Stage_level_2	nci:Stage_II	0.4
snomed:Endocrine_gland_structure	nci:Endocrine_Gland	0.62
snomed:Examination_under_anesthesia	nci:Examination_Under_Anesthesia	0.56
snomed:Marriage_life_event	nci:Married_Status	0.21
snomed:Carcinoembryonic_antigen	nci:CD66E_Antigen	0.54
snomed:Laboratory_test	nci:Test_Generic	0.22
snomed:Aprotinin	nci:Aprotinin_Bovine	0.58
snomed:Antidiabetic_preparation	nci:Anti-diabetic_Agent	0.47
snomed:Pulse_function	nci:Pulse_Rate	0.37
snomed:Specimen_obtained_by_aspiration	nci:Aspirate	0.14
snomed:Cannabis_dependence	nci:Cannabis_Dependence	0.7
snomed:Surgical_procedure_on_thorax	nci:Thoracic_Surgery	0.19
snomed:degrees_F	nci:F	0.0
snomed:Oil	nci:Oil	0.51
snomed:Pathological_process	nci:Pathologic_Process	0.5
snomed:Long	nci:Long_Value	0.5
snomed:Togo	nci:To	0.0
snomed:henry	nci:Henry	0.7
snomed:Extraction	nci:Extraction	0.5
snomed:Tumor_antigen	nci:Tumor_Antigen	0.56
snomed:Denileukin_Diftitox	nci:Denileukin_Diftitox	0.56
snomed:Secondary_malignant_neoplasm_of_neck	nci:Metastatic_Neoplasm_to_the_Neck	0.34
snomed:Gel	nci:Gel	0.5
snomed:Clinical_finding	nci:Finding	0.53
snomed:Unspecified_ptosis_of_eyelid	nci:Ptosis	0.39
snomed:Fibrinogen_assay	nci:Fibrinogen_Measurement	0.58
snomed:Carbon_dioxide_gas	nci:Carbon_Dioxide	0.47
snomed:Intradermal_nevus	nci:Intradermal_Nevus	0.68
snomed:Oxytocin_preparation	nci:Oxytocin	0.48
snomed:Biological_agent	nci:Biological_Agent	0.54
snomed:Radioisotope_scan_of_bone	nci:Bone_Scan	0.7
snomed:Cytotoxic_drug_therapy_NOS	nci:Cytotoxic	0.37
snomed:Atrial_myxoma_with_lentigines	nci:Lamb	0.0
snomed:Country	nci:Country	0.64
snomed:Segmented_neutrophil	nci:Segmented_Neutrophil	0.5
snomed:Sexual_behavior_finding	nci:Sex_Behavior	0.44
snomed:Child_of	nci:Children	0.45
snomed:degrees_K	nci:Kelvin	0.53
snomed:Complement_activation_alternative_pathway_function	nci:Alternative_Complement_Pathway	0.38
snomed:Mecasermin	nci:Recombinant_IGF-I	0.56
snomed:Corns_NOS	nci:Maize	0.4
snomed:Parameter	nci:Parameter	0.5
snomed:Dorsal	nci:Posterior	0.08
snomed:Head_structure	nci:Head	0.37
snomed:kilometer	nci:Km	0.0
snomed:Drug_tolerance	nci:Tolerance_Value	0.41
snomed:Medical_record_device	nci:Medical_Record	0.44
snomed:Dysplastic_nevus_of_skin	nci:NAD	0.0
snomed:Ulcer	nci:Ulcer	0.53
snomed:Structure_of_genitourinary_system	nci:Genitourinary_System	0.39
snomed:Otorrhea	nci:Otorrhea	0.64
snomed:Ribonucleic_acid	nci:Ribonucleic_Acid	0.52
snomed:Sexual_behavior	nci:Sex	0.27
snomed:Systemic_illness	nci:Systemic_Disease	0.24
snomed:Corneal_scar	nci:Corneal_Scar	0.59
snomed:Bone_structure_of_lumbar_vertebra	nci:Lumbar_Spine	0.01
snomed:Interferon_beta	nci:Interferon_Beta	0.62
snomed:Unspecified_ptosis_of_eyelid	nci:Eyelid_Ptosis	0.52
snomed:Book	nci:Book	0.5
snomed:Inspiration	nci:Inhaling	0.5
snomed:Plasminogen_activator	nci:Urokinase	0.51
snomed:Hybridoma	nci:Hybridoma	0.5
snomed:Hepatocellular_carcinoma_fibrolamellar	nci:Fibrolamellar_Hepatocellular_Carcinoma	0.62
snomed:Drug_powder	nci:Powder	0.38
snomed:Mitochondrial_RNA	nci:Mitochondrial_RNA	0.5
snomed:Thymus_gland_structure	nci:Thymus	0.34
snomed:Surgery	nci:Surgery	0.5
snomed:Autologous	nci:Autologous	0.61
snomed:Nuclear_medicine_imaging_procedure	nci:Radionuclide_Imaging	0.15
snomed:Dimensions	nci:Dimension	0.48
snomed:Evaluation_procedure	nci:Investigation	0.0
snomed:Viral_genome	nci:Viral_Genome	0.5
snomed:Gonadotropin	nci:Gonadotropin	0.53
snomed:Gonadotropin_releasing_factor_preparation	nci:Therapeutic_Gonadorelin	0.28
snomed:Recombinant_thrombin	nci:Thrombin	0.5
snomed:Extravasation	nci:Extravasation	0.5
snomed:Woman	nci:Woman	0.5
snomed:Figs	nci:Fellowship_for_the_Interpretation_of_Genomes	0.45
snomed:Metastatic_signet_ring_cell_carcinoma	nci:Metastatic_Signet_Ring_Cell_Carcinoma	0.59
snomed:Sermorelin	nci:Growth_Hormone-Releasing_Hormone	0.31
snomed:Gene_rearrangement	nci:Gene_Rearrangement	0.5
snomed:Urokinase	nci:Urokinase	0.65
snomed:Bone_structure_of_radius	nci:Radius	0.22
snomed:kBq	nci:Kilobecquerel	0.68
snomed:Apoptosis	nci:Apoptosis	0.5
snomed:Immunoglobulin_hypervariable_region	nci:Immunoglobulin_Hypervariable_Region	0.56
snomed:Feeding	nci:Feed	0.45
snomed:Administration_of_antineoplastic_agent	nci:Chemotherapy_Regimen_New	0.0
snomed:Somatostatin	nci:Growth_Hormone_Release_Inhibiting_Factor	0.5
snomed:Fusion_protein	nci:Fusion_Protein	0.53
snomed:Basophil_segmented	nci:Leukocyte_Myelocyte_Granulocyte_Basophil_MMHCC	0.51
snomed:Gamete_structure	nci:Germ_Cell	0.59
snomed:Colonic	nci:Colon	0.45
snomed:Class_Insecta	nci:Insect	0.38
snomed:Infantile_nephropathic_cystinosis	nci:Fanconi_Syndrome	0.07
snomed:Nutritional_supplement	nci:Nutritional_Supplement	0.54
snomed:DSenescence	nci:Senescence	0.48
snomed:Sunset_yellow_FCF_stain	nci:FD_C_Yellow_No_6	0.0
snomed:Solid_dose_form	nci:Solid_Dosage_Form	0.66
snomed:Suspension	nci:Suspension_Action	0.5
snomed:Secondary_malignant_neoplastic_disease	nci:Metastasis	0.0
snomed:Comedone	nci:Comedo	0.48
snomed:Oral_cavity_structure	nci:Oral_Cavity	0.42
snomed:Other_health_professional	nci:Other	0.31
snomed:Lectin	nci:Lectin	0.56
snomed:Phlebarteriectasia	nci:Vascular_Ectasia	0.06
snomed:New_bone_formation	nci:Bone_Formation	0.5
snomed:Iodine_131	nci:Iodine_131	0.48
snomed:Lumbar_spine_structure	nci:Lumbar_Vertebra	0.11
snomed:Colony_stimulating_factor_macrophage	nci:Recombinant_Macrophage_Colony-Stimulating_Factor	0.71
snomed:Echography	nci:Ultrasound_Imaging	0.35
snomed:Diagnostic_ultrasonography	nci:Diagnostic_Ultrasound	0.48
snomed:DOld_age	nci:Elderly	0.0
snomed:Dorsal	nci:Back	0.0
snomed:Microvolt	nci:Microvolt	0.74
snomed:Disorder_of_soft_tissue	nci:Soft_Tissue_Disorder	0.49
snomed:Retinal_dialysis	nci:Retinal_Tear	0.36
snomed:Breast_structure	nci:Breast	0.46
snomed:Drops_dose_form	nci:Drops	0.63
snomed:Left_ventricular_ejection_fraction	nci:Ejection_Fraction	0.5
snomed:Repeat	nci:Repeat_Pattern	0.5
snomed:Digital_subtraction_angiography	nci:Digital_Subtraction_Angiography	0.63
snomed:Anabolic_steroid_preparation	nci:Anabolic_Steroid	0.63
snomed:Ameloblastoma_malignant	nci:Metastasizing_Ameloblastoma	0.59
snomed:Disorder_of_gastrointestinal_tract	nci:Gastrointestinal_Disorder	0.5
snomed:Kingdom_Plantae	nci:Plant	0.27
snomed:Alkaline_phosphatase_measurement	nci:Alkaline_Phosphatase	0.43
snomed:Gonadorelin_agent	nci:Gonadotrophin_Releasing_Hormone	0.55
snomed:Chronic_obstructive_airways_disease_NOS	nci:Cold_Temperature	0.0
snomed:Ptosis_of_eyelid	nci:Ptosis	0.54
snomed:Corn	nci:Maize	0.55
snomed:Retention	nci:Retention	0.5
snomed:Pituitary_follicle_stimulating_hormone	nci:Follicle_Stimulating_Hormone	0.43
snomed:Liquid_dose_form	nci:Liquid	0.38
snomed:Structure_of_genitourinary_system	nci:Genitourinary_Route_of_Drug_Administration	0.3
snomed:Vasodilatation	nci:Vasodilation	0.5
snomed:Cardiovascular_function	nci:Cardiovascular_Physiology	0.29
snomed:Spray_dose_form	nci:Spray	0.37
snomed:Quantity_finding	nci:Amount	0.0
snomed:Bq	nci:Becquerel	0.14
snomed:Hallucinogen_dependence_unspecified	nci:Hallucinogen_Dependence	0.64
snomed:Contrast_radiography_of_esophagus	nci:Esophagram	0.34
snomed:Interleukin_12	nci:Interleukin-12	0.5
snomed:Branchial_cleft	nci:Pharyngeal_Groove	0.04
snomed:coulomb	nci:Coulomb	0.69
snomed:Recurrence	nci:Recurrence	0.5
snomed:Platelet_derived_growth_factor	nci:Platelet-Derived_Growth_Factor	0.65
snomed:Dosage	nci:Dose	0.5
snomed:Laboratory_procedure	nci:Test	0.54
snomed:Abdominal	nci:Abdominal	0.57
snomed:Stages	nci:Stage	0.47
snomed:Hospice	nci:Hospice	0.5
snomed:Operation_on_nervous_system	nci:Neurosurgical_Procedure	0.04
snomed:Thyrotropin_releasing_hormone_preparation	nci:Thyrotropin-Releasing_Hormone	0.5
snomed:DSenescence	nci:Elderly	0.0
snomed:Axillary	nci:Axilla	0.46
snomed:Meckel_s_diverticulum_unspecified	nci:Meckel_Diverticulum	0.47
snomed:Tuberculin_unit	nci:Tuberculin_Unit	0.69
snomed:Stain	nci:Stain	0.5
snomed:Lanugo	nci:Lanugo	0.5
snomed:Pulmonary	nci:Lung	0.0
snomed:Structure_showing_abnormal_deposition_of_pigment	nci:Pigmentation	0.19
snomed:Diverticular_disease	nci:Diverticulosis	0.42
snomed:Discharge_specimen	nci:Discharge_from_Healthcare_Facility	0.41
snomed:Approved	nci:Approved	0.5
snomed:Chronic_obstructive_pulmonary_disease_finding	nci:Cold_Temperature	0.0
snomed:Type	nci:Type	0.57
snomed:African_American	nci:Black	0.0
snomed:Drug_suspension	nci:Suspension	0.42
snomed:Fluorine	nci:F	0.0
snomed:Measurement_procedure	nci:Measure	0.41
snomed:Nuclear_medicine_diagnostic_procedure	nci:Scan	0.0
snomed:Inhaling	nci:Aspiration	0.0
snomed:Central_opacity_of_cornea	nci:Central_Opacity_of_Cornea	0.62
snomed:Bromelains	nci:Bromelain	0.5
snomed:Chronic_obstructive_lung_disease	nci:Cold_Temperature	0.0
snomed:Mediastinal	nci:Mediastinum	0.42
snomed:Smoker	nci:Current_Smoker	0.55
snomed:Insulin_product	nci:Regular_Insulin	0.26
snomed:Negative_beta_particle	nci:Electron	0.5
snomed:Immunoglobulin_hypervariable_region	nci:Immunoglobulin_Variable_Region	0.54
snomed:Biomedical_device	nci:Medical_Device	0.49
snomed:Gonadorelin_hydrochloride	nci:Gonadorelin_Hydrochloride	0.56
snomed:Structure_of_parenchyma_of_liver	nci:Hepatic_Tissue	0.09
snomed:Immunologic_tolerance_function	nci:Tolerance_Value	0.24
snomed:Diagnostic_nuclear_medicine_NOS	nci:Scan	0.0
snomed:Incontinentia_pigmenti_achromians_syndrome	nci:Nevus_of_Ito	0.17
snomed:Mitosis_function	nci:M_Stage	0.0
snomed:Radioisotope_function_study_of_liver	nci:Liver_Scan	0.0
snomed:Structure_of_axillary_fossa	nci:Axillary	0.25
snomed:Fractions	nci:Fraction	0.48
snomed:Ci	nci:Curie	0.17
snomed:Mouthwash	nci:Mouthwash	0.5
snomed:seconds	nci:Second_Name_Suffix	0.48
snomed:Hypertrophy	nci:Hypertrophy	0.5
snomed:Diagnostic_radiography_of_abdomen	nci:Abdominal_Radiography	0.3
snomed:Beta_interferon	nci:Therapeutic_Interferon_Beta	0.57
snomed:Mass_spectrometry_measurement	nci:Ms	0.0
snomed:Shave_excision	nci:Shaving_Procedure	0.55
snomed:Turner_syndrome	nci:Monosomy_X	0.03
snomed:Biomedical_equipment	nci:Medical_Device	0.06
snomed:Gray_color	nci:Gray	0.38
snomed:Gland_structure	nci:Gland	0.58
snomed:Pineapple_flavor	nci:Pineapple_Flavor	0.5
snomed:Embryonal_sarcoma	nci:Undifferentiated_Embryonal_Sarcoma	0.6
snomed:Inflammatory_disorder_of_the_eye	nci:Endophthalmitis	0.03
snomed:Lymphangiogram	nci:Lymphangiography	0.54
snomed:Mucin	nci:Mucin	0.56
snomed:Induration	nci:Induration	0.5
snomed:Oral_cavity_finding	nci:Oral_Cavity_Finding	0.54
snomed:Collagen_product	nci:Collagen	0.44
snomed:ppm	nci:Part_Per_Million	0.65
snomed:Thyroglobulin	nci:Thyroglobulin	0.54
snomed:Venous_structure	nci:Venous	0.37
snomed:Somatotropin_preparation	nci:Growth_Hormone	0.44
snomed:Colony_stimulating_factor_macrophage	nci:Colony_Stimulating_Factor-1	0.57
snomed:Surgery	nci:Surgical_Procedure	0.5
snomed:Polykaryocyte	nci:Giant_Cell	0.0
snomed:Mesenchymal_cell_atypia	nci:Mesenchymal_Cell_Atypia	0.56
snomed:Potassium_product	nci:Potassium	0.42
snomed:Thyrotropin_releasing_factor	nci:Protirelin	0.18
snomed:Person	nci:Person	0.6
snomed:Rasburicase	nci:Rasburicase	0.5
snomed:Drug_resistance	nci:Drug_Resistance	0.5
snomed:Proto_oncogene	nci:Proto-Oncogene	0.5
snomed:Male_structure	nci:Male_Gender	0.34
snomed:Visual_system_disorder	nci:Vision_Disorder	0.5
snomed:Sensitization_drug	nci:Drug_Sensitization	0.5
snomed:Secondary_Ca_NOS	nci:Metastasis	0.0
snomed:Physical_examination_procedure	nci:Assessed	0.0
snomed:Head_and_neck_structure	nci:Head_and_Neck	0.43
snomed:Therapeutic_aspiration_procedure	nci:Therapeutic_Aspiration	0.53
snomed:Retroperitoneal	nci:Retroperitoneal_Space	0.46
snomed:Acrosyringeal_nevus	nci:Acrosyringeal_Nevus	0.55
snomed:Drug_or_medicament	nci:Medication	0.32
snomed:Phase	nci:Stage_Generic	0.0
snomed:Second	nci:Second_Unit_of_Time	0.5
snomed:Myelogram	nci:Myelography	0.61
snomed:Myelitis	nci:Myelitis	0.56
snomed:Hydroxocobalamin	nci:Hydroxocobalamin	0.5
snomed:Disorder_of_endocrine_system	nci:Endocrine_Disorder	0.48
snomed:Usage	nci:Usage	0.5
snomed:Disorder_of_nervous_system	nci:Nervous_System_Disorder	0.59
snomed:International_normalized_ratio	nci:International_Normalized_Ratio	0.5
snomed:Gonadotropin_releasing_factor_preparation	nci:Gonadotrophin_Releasing_Hormone	0.37
snomed:newton	nci:N	0.0
snomed:Echinacea_preparation	nci:Echinacea	0.39
snomed:Perineural_route	nci:Perineural	0.56
snomed:Reticulin	nci:Reticular_Fiber	0.32
snomed:Staining_method	nci:Staining	0.42
snomed:Surgical	nci:Surgical_Procedure	0.5
snomed:Pyrazole	nci:_1H-Pyrazole	0.55
snomed:Female_mammary_gland_structure	nci:Female_Breast	0.13
snomed:Growth_factor	nci:Mitogen	0.0
snomed:Orange_flavor	nci:Orange	0.4
snomed:Sample_hemolyzed	nci:Hemolysis_in_Specimen	0.0
snomed:Courses	nci:Course	0.48
snomed:Spongiform_encephalopathy	nci:Prion_Disease_Pathway	0.05
snomed:Lithium	nci:Lithium_Ion	0.5
snomed:Prokaryotic_cell_component	nci:Prokaryotic_Cell_Component	0.5
snomed:Donor	nci:Donor	0.5
snomed:international_units_per_kilogram	nci:International_Unit_per_Kilogram	0.62
snomed:Middle_ear_structure	nci:Ear_Middle_Ear_MMHCC	0.4
snomed:international_units	nci:International_Unit_of_Biological_Activity	0.67
snomed:Hypericum_perforatum	nci:Hypericum_Perforatum	0.5
snomed:Secondary_malignant_neoplasm_of_trachea	nci:Metastatic_Neoplasm_to_the_Trachea	0.65
snomed:Nutritional_supplement	nci:Supplement_Document	0.32
snomed:Phosphorus	nci:Phosphorous	0.39
snomed:kIU	nci:Kilointernational_Unit	0.78
snomed:Trunk_structure	nci:Trunk	0.37
snomed:Extravasation	nci:Leakage	0.03
snomed:Deoxyribonucleic_acid_damage	nci:DNA_Damage	0.07
snomed:Upper_limb_structure	nci:Arm	0.05
snomed:Child	nci:Children	0.5
snomed:Duodenal	nci:Duodenum	0.38
snomed:Creatinine_measurement	nci:Creatinine	0.39
snomed:Bacterial_count	nci:Bacteria	0.42
snomed:Luxembourg	nci:Lux	0.31
snomed:Dietary_fiber	nci:Nutrition_Fiber	0.0
snomed:Therapy_related_acute_myeloid_leukemia_and_myelodysplastic_syndrome	nci:Therapy-Related_Acute_Myeloid_Leukemia_and_Myelodysplastic_Syndrome	0.65
snomed:Pituitary_luteinizing_hormone	nci:Therapeutic_Luteinizing_Hormone	0.44
snomed:Encephalitis	nci:Encephalitis	0.58
snomed:Activin_hormone	nci:Recombinant_Activin	0.4
snomed:Childhood_age_person	nci:Child_Offspring	0.38
snomed:Infection_of_amniotic_cavity	nci:Amnionitis	0.09
snomed:Problem	nci:Publication_Issue	0.0
snomed:Protirelin	nci:Protirelin	0.53
snomed:Complete_trisomy_21_syndrome	nci:Down_Syndrome	0.47
snomed:Lymphocyte	nci:Lymphocyte	0.88
snomed:Lymphangiogram	nci:Lymphangiogram	0.5
snomed:Disorder_of_eye_proper	nci:Eye_Disorder	0.43
snomed:Tonga	nci:Tonga	0.61
snomed:Colony_stimulating_factor	nci:Colony_Stimulating_Factor	0.62
snomed:Philippines	nci:pH	0.0
snomed:Thyroid_hormone	nci:Thyroid_Hormone	0.7
snomed:Cocaine_type_drug_dependence	nci:Cocaine_Dependence	0.58
snomed:Contagious_disease	nci:Infectious_Disease_Pathway	0.28
snomed:Disruption	nci:Disruption	0.5
snomed:Equal	nci:Equality	0.47
snomed:Downy_hair	nci:Lanugo	0.0
snomed:Echinacea_extract	nci:Echinacea_Plant	0.45
snomed:Insulin	nci:Insulin	0.52
snomed:Echography	nci:Sonogram	0.06
snomed:Nuclear_medicine_imaging_procedure	nci:Scanning_Procedure_or_Technique	0.02
snomed:Juice	nci:Juice	0.58
snomed:Plastic_operation	nci:Plastic_Surgery_Procedure	0.24
snomed:Retinal_disorder	nci:Retinal_Disorder	0.66
snomed:Deletion_of_chromosome_NOS	nci:Chromosomal_Deletion	0.4
snomed:Malignant_tumor_of_unknown_origin	nci:Metastatic_Neoplasm_of_Unknown_Primary_Origin	0.35
snomed:Coagulation_factor	nci:Coagulation_Factor	0.78
snomed:Abnormal_macrophage	nci:Abnormal_Macrophage	0.68
snomed:Man	nci:Man	0.5
snomed:Intestinal	nci:Intestine	0.44
snomed:Protirelin	nci:Thyrotropin-Releasing_Hormone	0.06
snomed:Thoracic_structure	nci:Chest	0.01
snomed:Physical_object	nci:Object	0.3
snomed:Multiple_gated_acquisition_scanning	nci:Radionuclide_Ventriculogram_Scan	0.63
snomed:Pancreatic_structure	nci:Pancreatic	0.41
snomed:Infant	nci:Infant	0.5
snomed:Tissue_plasminogen_activator	nci:Tissue_Plasminogen_Activator	0.61
snomed:Malignant_neoplasm_of_lateral_wall_of_urinary_bladder	nci:Lateral_Wall_of_the_Bladder	0.3
snomed:Lobelia_inflata	nci:Lobelia_inflata	0.61
snomed:Gingival_structure	nci:Gum	0.0
snomed:White_color	nci:White	0.4
snomed:Lanreotide	nci:Lanreotide	0.5
snomed:Carcinoma_metastatic	nci:Metastatic_Carcinoma	0.56
snomed:Thrombolytic_agent	nci:Thrombolytic_Agent	0.59
snomed:Triacylglycerol_lipase_measurement	nci:Lipase	0.16
snomed:Lymphoma_of_kidney	nci:Renal_Lymphoma	0.69
snomed:Kingdom_Protozoa	nci:Protozoal	0.3
snomed:Foods	nci:Food	0.5
snomed:Fluorescence_in_situ_hybridization	nci:Fish_Vertebrates	0.0
snomed:Abdominal_structure	nci:Abdominal_Cavity	0.26
snomed:Nasal_structure	nci:Nose	0.01
snomed:Myeloblastin	nci:Proteinase-3	0.63
snomed:Tray	nci:Tray	0.5
snomed:Recurrent	nci:Recurrence	0.44
snomed:Abnormal_cell	nci:Abnormal_Cell	0.56
snomed:Contraceptive_diaphragm_device	nci:Diaphragm	0.24
snomed:Female_structure	nci:F	0.0
snomed:Frequencies	nci:Frequency	0.77
snomed:Transmissible_disease	nci:Infectious_Disease_Pathway	0.04
snomed:Encephalomyelitis	nci:Encephalomyelitis	0.63
snomed:Glass	nci:Glass_Container	0.5
snomed:Corn	nci:Corn	0.5
snomed:State	nci:US_State	0.5
snomed:Leuprorelin	nci:Leuprolide	0.46
snomed:Picture	nci:Picture	0.5
snomed:Gum	nci:Gum	0.5
snomed:Hallucinogen_dependence_episodic	nci:Hallucinogen_Dependence_Episodic_Use	0.71
snomed:Gingival_structure	nci:Gingiva	0.39
snomed:Traumatic_injury	nci:Injury	0.42
snomed:Monocyte_count_NOS	nci:Monocyte_Count	0.83
snomed:Dizygotic_twins	nci:Fraternal_Twin	0.0
snomed:Tangerine	nci:Tangerine_Flavor	0.5
snomed:Laryngeal_route	nci:Laryngeal_Route_of_Drug_Administration	0.54
snomed:Nutrient_supplementation	nci:Supplement	0.3
snomed:Plain_film	nci:X-Ray	0.0
snomed:Intralesional_route	nci:Intralesional_Route_of_Drug_Administration	0.55
snomed:Channel	nci:Passage	0.0
snomed:French	nci:French	0.56
snomed:Surgical_procedure	nci:Surgical	0.39
snomed:Genetic_inversion	nci:Inversion	0.36
snomed:Embryonic_structure	nci:Embryonic_Structure	0.53
snomed:Peptide_hydrolase	nci:Proteolytic_Enzymes	0.0
snomed:Drug_therapy	nci:Pharmacological_Treatment	0.21
snomed:Material	nci:Material	0.5
snomed:Denture	nci:Denture	0.5
snomed:Stage_level_1	nci:Stage_I	0.38
snomed:Shampoo_dose_form	nci:Shampoo	0.39
snomed:Technique	nci:Techniques	0.5
snomed:Inspiration	nci:Inhalation	0.42
snomed:Relationships	nci:Related	0.49
snomed:Edentulous	nci:Edentulous	0.5
snomed:Montserrat_island	nci:Ms	0.0
snomed:Adult	nci:Adult	0.5
snomed:Caucasian	nci:White_Color	0.0
snomed:Respiratory_finding	nci:Respiratory_System_Finding	0.52
snomed:Stage_level_5	nci:Stage_V	0.43
snomed:Postoperative_wound_infection_unspecified	nci:Surgical_Wound_Infection	0.21
snomed:Filgrastim	nci:Filgrastim	0.66
snomed:Mature_cystic_teratoma	nci:Dermoid	0.0
snomed:Therapeutic_abortion_procedure	nci:Therapeutic_Abortion	0.44
snomed:Graft_acceptance	nci:Engraftment	0.0
snomed:Albumin_measurement	nci:Albumin	0.37
snomed:Surgical	nci:Surgery	0.24
snomed:Acne	nci:Acne	0.52
snomed:Blood_pressure_finding	nci:Blood_Pressure	0.44
snomed:Occupation	nci:Occupation	0.52
snomed:Substance_abuse	nci:Substance_Abuse	0.54
snomed:Immunoglobulin_variable_region	nci:Immunoglobulin_Variable_Region	0.56
snomed:Grade	nci:Histopathologic_Grade	0.5
snomed:Diagnostic_ultrasonography	nci:Ultrasound_Imaging	0.41
snomed:Penile_erection	nci:Erection	0.36
snomed:Polyacrylamide_gel_electrophoresis	nci:Page	0.0
snomed:Surgical_procedure_on_thorax	nci:Thoracic_Surgical_Procedures	0.55
snomed:Alpha_particle	nci:Alpha_Radiation	0.42
snomed:Plasminogen_activator_product	nci:Plasminogen_Activator	0.56
snomed:Egg_yolk	nci:Egg_Yolk	0.54
snomed:Interleukin_8	nci:Therapeutic_Interleukin-8	0.61
snomed:Congenital_anomaly	nci:Congenital_Abnormality	0.55
snomed:Dysplastic_nevus	nci:NAD	0.0
snomed:Type	nci:Terminology_Kind	0.0
snomed:Asphyxiation	nci:Suffocation	0.5
snomed:Medical_gas_cylinder	nci:Cylinder	0.32
snomed:Cord_blood	nci:Umbilical_Cord_Blood	0.54
snomed:Signal_transduction_function	nci:Signal_Transduction	0.45
snomed:Drug_dependence_NOS	nci:Drug_Dependence	0.56
snomed:Experimental_allergic_encephalomyelitis	nci:Experimental_Allergic_Encephalomyelitis	0.5
snomed:Somatostatin_preparation	nci:Somatostatin	0.43
snomed:Gonadotropin	nci:Therapeutic_Gonadotropin	0.69
snomed:Arthus_reaction_function	nci:Arthus_Reaction	0.43
snomed:Elderly_person	nci:Elderly	0.41
snomed:Materials	nci:Material	0.49
snomed:Sexual_behavior_finding	nci:Sex_Personal_Attribute	0.24
snomed:Finding_of_sense_of_taste	nci:Taste	0.19
snomed:Transfer_RNA	nci:Transfer_RNA	0.5
snomed:Thyroglobulin_preparation	nci:Thyroglobulin	0.41
snomed:Parenteral_form_dosage_form	nci:Parenteral_Dosage_Form	0.47
snomed:Interleukin_2	nci:Interleukin-2	0.65
snomed:Orange_color	nci:Orange	0.41
snomed:Greater_than_symbol_gt	nci:Greater_Than	0.42
snomed:Collagen	nci:Collagen	0.65
snomed:Pancrelipase	nci:Pancrelipase	0.5
snomed:Behavior_finding	nci:Conation	0.0
snomed:Thyrotropin_releasing_factor_agent	nci:Protirelin	0.16
snomed:Carbon_dioxide_content_measurement	nci:Carbon_Dioxide	0.38
snomed:Sample_lipemic	nci:Lipemic_Specimen	0.11
snomed:Mesenteric	nci:Mesentery	0.44
snomed:Device	nci:Device	0.5
snomed:Disorder_of_vision	nci:Visual_Field_Disorder	0.24
snomed:Surgical_procedure	nci:Surgical_Procedure	0.56
snomed:Tumor_stage	nci:Stage_Generic	0.33
snomed:Fibroblastic_cell_atypia	nci:Fibroblastic_Cell_Atypia	0.56
snomed:Anal	nci:Anus	0.5
snomed:Pulse_rate	nci:Pulse_Phenomenon	0.41
snomed:Cocaine_dependence_unspecified	nci:Cocaine_Dependence	0.62
snomed:Genital_structure	nci:Genital	0.38
snomed:Pelvic_structure	nci:Pelvic	0.37
snomed:Pelvic_structure	nci:Pelvis	0.29
snomed:Sexual_activity	nci:Sex_Personal_Attribute	0.27
snomed:Surgical	nci:Surgical	0.5
snomed:Sex_structure	nci:Sex	0.29
snomed:Russians	nci:Russian	0.54
snomed:Macrophage	nci:Macrophage	0.62
snomed:Enterostomy	nci:Enterostomy	0.64
snomed:Disorder_of_cornea	nci:Corneal_Disorder	0.54
snomed:Immune_enhancement_agent	nci:Immunostimulant	0.02
snomed:Infiltrate_of_cornea	nci:Corneal_Infiltration	0.59
snomed:Grading	nci:Grade	0.35
snomed:Achromic_nevus	nci:Nonpigmented_Nevus	0.11
snomed:perc_positive_cells	nci:Percent_of_Positive_Cells	0.68
snomed:Pulse_rate	nci:Pulse	0.5
snomed:Plastic_operation	nci:Plastic_Surgery	0.19
snomed:Industrial_agent	nci:Industrial_Product	0.34
snomed:Protective_agent	nci:Protective_Agent	0.5
snomed:Pulmonary	nci:Pulmonary	0.59
snomed:Laboratory_procedures_general	nci:Test_Generic	0.0
snomed:Disorder_of_meninges	nci:Meninges	0.35
snomed:Orange_color	nci:Orange_Fruit	0.41
snomed:Function	nci:Function	0.5
snomed:Repeat	nci:Repeat	0.5
snomed:Disorder_of_thyroid_gland	nci:Thyroid_Gland_Disorder	0.69
snomed:Thoracic	nci:Thoracic	0.59
snomed:Microgram_per_specimen	nci:Microgram_per_Specimen	0.68
snomed:Seed	nci:Seeds	0.47
snomed:Perfusion	nci:Perfusion	0.56
snomed:Immunocytochemical_procedure	nci:Immunocytochemistry	0.34
snomed:Serine_protease	nci:Serine_Protease	0.56
snomed:Immunoglobulin_switch_region	nci:Immunoglobulin_Switch_Region	0.5
snomed:Subatomic_particle	nci:Elementary_Particles	0.06
snomed:Trace_element	nci:Micronutrient_Property	0.0
snomed:Cone	nci:Cone	0.5
snomed:Milliunit	nci:Milliunit	0.68
snomed:Down_s_syndrome_NOS	nci:Trisomy_21	0.0
snomed:Measurement	nci:Measurement	0.5
snomed:Benign_neoplasm_of_stomach_NOS	nci:Benign_Mouse_Gastric_Neoplasm	0.34
snomed:Antibody_class	nci:Antibody_Isotype	0.27
snomed:Atypical_cells_of_undetermined_significance	nci:Atypical_Cells_of_Uncertain_Significance	0.91
snomed:Immune_hypersensitivity_disorder	nci:Hypersensitivity	0.39
snomed:Disorder_of_cornea	nci:Cornea	0.27
snomed:Measurement_procedure	nci:Measurement	0.41
snomed:Disorder_of_thorax	nci:Thoracic_Disorder	0.41
snomed:Ovis_aries	nci:Sheep	0.51
snomed:Cocaine_dependence_continuous	nci:Cocaine_Dependence_Continuous_Use	0.7
snomed:Scar	nci:Scar	0.53
snomed:Taste_sense_altered	nci:Dysgeusia	0.11
snomed:Pentetreotide	nci:Pentetreotide	0.5
snomed:Concentration_function	nci:Attention_Concentration	0.49
snomed:Retroperitoneal	nci:Retroperitoneal	0.59
snomed:Vanilla	nci:Vanilla_Flavor	0.5
snomed:Lumbar	nci:Lumbar_Region	0.4
snomed:Gene_function	nci:Gene_Function	0.5
snomed:Appearances	nci:Appearance	0.5
snomed:Fibrinogen_measurement	nci:Fibrinogen	0.39
snomed:Anthracene	nci:Anthracene	0.53
snomed:Oral_dosage_form	nci:Oral_Dosage_Form	0.54
snomed:Maple_syrup	nci:Maple_Syrup	0.55
snomed:Deficiency_of_DNA_repair	nci:DNA_Repair_Disorder	0.48
snomed:calorie	nci:Nutrition_Calories	0.5
snomed:Lemon_flavor	nci:Lemon	0.39
snomed:Autoimmune_state	nci:Autoimmune_Status	0.46
snomed:Cone	nci:Cone_Shape	0.5
snomed:Glucagon	nci:Glucagon	0.53
snomed:Cytokine	nci:Cytokine	0.75
snomed:Granules_dose_form	nci:Granule	0.38
snomed:Exhaling	nci:Expiration_Respiration	0.5
snomed:Immune_system_finding	nci:Immune_System_Finding	0.52
snomed:Disorder_of_intestine	nci:Intestinal_Disorder	0.5
snomed:Informing	nci:Reporting	0.0
snomed:Base_sequence	nci:Sequence	0.4
snomed:Intranuclear_inclusion	nci:Nuclear_Inclusion	0.43
snomed:Vaginal_contraceptive_diaphragm	nci:Diaphragm	0.24
snomed:Platelet	nci:Platelet	0.55
snomed:Secondary_malignant_neoplasm_of_parathyroid_gland	nci:Metastatic_Parathyroid_Neoplasm	0.53
snomed:Respiratory_surfactant	nci:Lung_Surfactant	0.32
snomed:Chest_infection_NOS	nci:Lower_Respiratory_Tract_Infection	0.24
snomed:Secondary_malignant_neoplastic_disease	nci:Metastatic_Neoplasm	0.11
snomed:Asphyxiation	nci:Asphyxia	0.44
snomed:Immunoglobulin_idiotype	nci:Idiotype	0.29
snomed:Lysis	nci:Lytic	0.0
snomed:Hepatocellular_carcinoma	nci:Hepatocellular_Carcinoma	0.57
snomed:Canister_device	nci:Drug_Canister	0.42
snomed:Inhaling	nci:Inhalation	0.26
snomed:Disorder_of_connective_tissue	nci:Connective_Tissue_Disorder	0.52
snomed:Trimesters	nci:Trimester	0.48
snomed:Microcytic_erythrocyte	nci:Microcytic_Red_Blood_Cell	0.27
snomed:Therapy_related_myelodysplastic_syndrome	nci:Therapy-Related_Myelodysplastic_Syndrome	0.67
snomed:Histologic_grade	nci:Grade	0.25
snomed:Tooth_structure	nci:Tooth	0.4
snomed:Low_density_lipoprotein	nci:Low_Density_Lipoprotein	0.6
snomed:Kallikrein	nci:Kallikrein	0.62
snomed:Digestant	nci:Digestant	0.5
snomed:Radiographic_imaging_procedure	nci:Radiography	0.4
snomed:M_category	nci:M_Stage	0.0
snomed:Recombinant_protein	nci:Recombinant_Protein	0.52
snomed:degrees_F	nci:Degree_Fahrenheit	0.5
snomed:Less_than_symbol_lt	nci:Less_Than	0.4
snomed:Lysis	nci:Lysis	0.5
snomed:Occurrences	nci:Occurrence	0.5
snomed:Aortic	nci:Aorta	0.5
snomed:Phenylpyruvate_tautomerase	nci:Macrophage_Migration_Inhibitory_Factor	0.56
snomed:Syrup	nci:Syrup_Dosage_Form	0.58
snomed:Complete_trisomy_21_syndrome	nci:Trisomy_21	0.26
snomed:Intramuscular	nci:Intramuscular	0.59
snomed:Norwegians	nci:Norwegian	0.54
snomed:Travel	nci:Travel	0.5
snomed:Measurement	nci:Measure	0.5
snomed:Lenograstim	nci:Lenograstim	0.7
snomed:Retroperitoneal	nci:Retroperitoneum	0.46
snomed:X_ray_electromagnetic_radiation	nci:X-Ray	0.71
snomed:Laryngeal_structure	nci:Laryngeal	0.4
snomed:Intravenous_infusion	nci:Intravenous_Infusion	0.57
snomed:Human_chorionic_gonadotropin	nci:Human_Chorionic_Gonadotropin	0.5
snomed:Hypersensitivity	nci:Hypersensitivity	0.5
snomed:Cosyntropin	nci:Cortrsyn	0.5
snomed:Aging	nci:Aging	0.5
snomed:Laryngeal_route	nci:Laryngeal	0.56
snomed:Diverticula_of_intestine	nci:Diverticulosis	0.31
snomed:Hemoglobin_determination	nci:Hemoglobin	0.38
snomed:Benign_neoplasm_of_stomach_NOS	nci:Benign_Gastric_Neoplasm	0.7
snomed:Foods	nci:Food_and_Food_Product	0.5
snomed:Aspiration_of_breast	nci:Aspiration_of_Breast	0.75
snomed:Melanocytic_nevus	nci:Pigmented_Nevus	0.17
snomed:Axillary_region_structure	nci:Axillary	0.35
snomed:Intramuscular_injection_NOS	nci:Intramuscular_Injection	0.51
snomed:Vascular_dilatation_function	nci:Vasodilation	0.42
snomed:New_bone_formation	nci:Immature_Bone	0.12
snomed:Thoracic	nci:Thorax	0.37
snomed:Lupus_erythematosus	nci:LE_Cell	0.47
snomed:Recurrent	nci:Recurrent	0.56
snomed:Presentation	nci:Present	0.42
snomed:Egyptians	nci:Egyptian	0.54
snomed:Antiserum	nci:Antiserum	0.55
snomed:Urea	nci:Carbamide	0.5
snomed:Kallikrein_inactivator_unit	nci:Kallikrein_Inhibitor_Unit	0.69
snomed:Management_procedure	nci:Management	0.41
snomed:Oxytocin_preparation	nci:Therapeutic_Oxytocin	0.4
snomed:DRespiratory_failure	nci:Respiratory_Failure	0.49
snomed:Retinal_structure	nci:Eye_Retina_MMHCC	0.36
snomed:Connective_tissue_fiber	nci:Connective_Tissue_Fiber	0.61
snomed:Carbon_dioxide_content_measurement	nci:Carbon_Dioxide_Measurement	0.54
snomed:Anal	nci:Anal	0.5
snomed:Metaplasia	nci:Metaplasia	0.71
snomed:Surgical_margins	nci:Surgical_Margin	0.5
snomed:Fluoroscopy	nci:Fluoroscopy	0.51
snomed:Deoxyribonucleic_acid_repair	nci:DNA_Repair	0.07
snomed:perc_hemolysis	nci:Percent_Hemolysis	0.68
snomed:Lung_structure	nci:Pulmonary	0.0
snomed:Turner_s_syndrome_NOS	nci:Turner_s_Syndrome	0.52
snomed:Creatine_kinase_measurement	nci:Creatine_Kinase	0.42
snomed:Chorioamnionitis	nci:Chorioamnionitis	0.61
snomed:Childhood_age_person	nci:Children	0.33
snomed:Intravenous_pyelogram	nci:Intravenous_Pyelogram	0.5
snomed:Biomedical_device	nci:Device	0.27
snomed:Immunoglobulin_joining_region	nci:Immunoglobulin_Joining_Region	0.56
snomed:Dependence	nci:Dependence	0.5
snomed:Junctional_nevus	nci:Junction_Nevus	0.69
snomed:Teaching_principal_NOS	nci:Principal	0.31
snomed:Relative	nci:Relative_Value	0.5
snomed:Glucose_measurement_plasma	nci:Glucose	0.34
snomed:Test_finding	nci:Test_Result	0.15
snomed:Retroperitoneal_structure	nci:Retroperitoneal_Space	0.38
snomed:Disorder_of_digestive_tract	nci:Gastrointestinal_Disorder	0.3
snomed:Parathormone_related_peptide	nci:Parathyroid_Hormone-Like_Hormone	0.46
snomed:Ulcerative	nci:Ulceration	0.41
snomed:Origin	nci:Begin	0.16
snomed:Kidney_structure	nci:Renal	0.0
snomed:Male_genital	nci:Male_Genitalia	0.48
snomed:Standard_deviation	nci:Standard_Deviation	0.5
snomed:Allergic_encephalomyelitis	nci:Experimental_Allergic_Encephalomyelitis	0.4
snomed:Pineapple_flavor	nci:Pineapple	0.43
snomed:Second	nci:Second	0.61
snomed:Tumor_embolus	nci:Tumor_Embolism	0.41
snomed:Water_product	nci:Water	0.38
snomed:Retrograde_pyelogram	nci:Retrograde_Pyelogram	0.5
snomed:Structure_of_reticuloendothelial_system	nci:Reticuloendothelial_System	0.42
snomed:Intravenous_injection	nci:Intravenous_Bolus	0.59
snomed:Organism	nci:Organisms	0.54
snomed:Vitamin	nci:Vitamin	0.76
snomed:Human_menopausal_gonadotrophins	nci:Human_Menopausal_Gonadotropin	0.46
snomed:Stop	nci:End	0.13
snomed:Heroin_dependence	nci:Heroin_Dependence	0.72
snomed:Presentation	nci:Presentation	0.5
snomed:Injury_of_cornea	nci:Corneal_Injury	0.62
snomed:Finding_relating_to_sexuality_and_sexual_activity	nci:Sex_Personal_Attribute	0.07
snomed:Demineralized_structure	nci:Decalcification	0.0
snomed:Intramyometrial_route	nci:Intramyometrial_Route_of_Administration	0.54
